(house)painter	kladschilder;schilder
Adhikar	Adigaar;Adigar
Adigaar	Adhikar;Adigar
Adigar	Adhikar;Adigaar
Administration and government	politique bedienden
Baas Scheeps Timmerm	baas der scheepstimmerlieden;baas der scheepstimmermannen;baas der scheepstimmerwerf;baas der scheeptimmerlieden;baas der schipstimmerwerf;opperscheepstimmerman;senior ship carpenter
Equipagemaster	equipagemeester;equipagie meester;equipagiemeester;equipasie opziender
Francisca pater	Franciscand pater;paater;pater
Franciscand pater	Francisca pater;paater;pater
Inlands leermeester	docent;leermeester;meester
Jo: assistent bij den oppertolk	jong tolk
Jong assistent	jo: adsistend;jo: assistent;jong adsistend;jong koopmansassistent;jongen adsistent;junior assistant to the (chief) merchant;junior merchants assistant
Lascarin	Lascorijn
Lascorijn	Lascarin
Militaire officieren	offecier;officer;officier
Muzikanten	musician
Onder-major	ondermajoor
Onder-watermaker	Water-maker's mate;onderwatermaker
Opermeester van 's komps: Hospitaal	operchirurgijn;opermeester;oppercheriorgijn;opperchigeirgijn;opperchirugijn;opperchirurgeijn;opperchirurgijn;oppermeester;senior medical master;senior surgeon
Opsiender der houtthuin	Opsiender der scheeps timmerwerff;Opsiender der scheepstimmerwerf;Opsiender der wapencamer;Opziender van de Smitswinkel;opsiender;opsiender der houtthuijn;opziender;opziener
Opsiender der scheeps timmerwerff	Opsiender der houtthuin;Opsiender der scheepstimmerwerf;Opsiender der wapencamer;Opziender van de Smitswinkel;opsiender;opsiender der houtthuijn;opziender;opziener
Opsiender der scheepstimmerwerf	Opsiender der houtthuin;Opsiender der scheeps timmerwerff;Opsiender der wapencamer;Opziender van de Smitswinkel;opsiender;opsiender der houtthuijn;opziender;opziener
Opsiender der wapencamer	Opsiender der houtthuin;Opsiender der scheeps timmerwerff;Opsiender der scheepstimmerwerf;Opziender van de Smitswinkel;opsiender;opsiender der houtthuijn;opziender;opziener
Opziender van de Smitswinkel	Opsiender der houtthuin;Opsiender der scheeps timmerwerff;Opsiender der scheepstimmerwerf;Opsiender der wapencamer;opsiender;opsiender der houtthuijn;opziender;opziener
Pl: kapitain luitenant der artillerije	lieutenant der arthillerie;lieutenant der arthillerije;luitenant van de artillerie;luitenant-ingenieur;sousluitenant der artillerie;sousluitenant der artillerij
Raad van Indië	Raad van Nederlandse India;extraordinaris raedt van india;lid van de Raad van Indië;raad extra ordinair van India 
Raad van Nederlandse India	Raad van Indië;extraordinaris raedt van india;lid van de Raad van Indië;raad extra ordinair van India 
Raad van Politie	lid van de Politieke Raad;lid van de Raad van Politie
Sarawadi	Sarawadij;Sarwadi;Sarwadi Karyakkaran;sarbadikariakaar
Sarawadij	Sarawadi;Sarwadi;Sarwadi Karyakkaran;sarbadikariakaar
Sarwadi	Sarawadi;Sarawadij;Sarwadi Karyakkaran;sarbadikariakaar
Sarwadi Karyakkaran	Sarawadi;Sarawadij;Sarwadi;sarbadikariakaar
Water-maker's mate	Onder-watermaker;onderwatermaker
absolut assistent	absoluut assistent;adsistend;adsistendt;adsistent;adssistent;adssitend;asdsistent;asiestend;asistent;assistant;assistant to the (chief) merchant;assistend;assistendt;assistent;merchant's assistant;schrijver
absoluut assistent	absolut assistent;adsistend;adsistendt;adsistent;adssistent;adssitend;asdsistent;asiestend;asistent;assistant;assistant to the (chief) merchant;assistend;assistendt;assistent;merchant's assistant;schrijver
acting governor-general	gouverneur-generaal;governor general
adelborts	aldelborst;midshipman
adjudant	adjundant;onderadjudant
adjunct-boswachter	boswagters adjunct
adjundant	adjudant;onderadjudant
adsistend	absolut assistent;absoluut assistent;adsistendt;adsistent;adssistent;adssitend;asdsistent;asiestend;asistent;assistant;assistant to the (chief) merchant;assistend;assistendt;assistent;merchant's assistant;schrijver
adsistendt	absolut assistent;absoluut assistent;adsistend;adsistent;adssistent;adssitend;asdsistent;asiestend;asistent;assistant;assistant to the (chief) merchant;assistend;assistendt;assistent;merchant's assistant;schrijver
adsistent	absolut assistent;absoluut assistent;adsistend;adsistendt;adssistent;adssitend;asdsistent;asiestend;asistent;assistant;assistant to the (chief) merchant;assistend;assistendt;assistent;merchant's assistant;schrijver
adssistent	absolut assistent;absoluut assistent;adsistend;adsistendt;adsistent;adssitend;asdsistent;asiestend;asistent;assistant;assistant to the (chief) merchant;assistend;assistendt;assistent;merchant's assistant;schrijver
adssitend	absolut assistent;absoluut assistent;adsistend;adsistendt;adsistent;adssistent;asdsistent;asiestend;asistent;assistant;assistant to the (chief) merchant;assistend;assistendt;assistent;merchant's assistant;schrijver
advocaat fiscaal	advocaat-fiscaal
advocaat-fiscaal	advocaat fiscaal
aldelborst	adelborts;midshipman
an-nakhoda	anachoda;annakhoda;nachoda;nakhuda
anachoda	an-nakhoda;annakhoda;nachoda;nakhuda
annakhoda	an-nakhoda;anachoda;nachoda;nakhuda
appointe	appointee;appointé
appointee	appointe;appointé
appointé	appointe;appointee
apprentice helmsman	halfwaak
apprentice surgeon	barberot
araatchie	araatje;arache;aratja;aratje;arraci;arratja;arratje
araatje	araatchie;arache;aratja;aratje;arraci;arratja;arratje
arache	araatchie;araatje;aratja;aratje;arraci;arratja;arratje
aratja	araatchie;araatje;arache;aratje;arraci;arratja;arratje
aratje	araatchie;araatje;arache;aratja;arraci;arratja;arratje
arraci	araatchie;araatje;arache;aratja;aratje;arratja;arratje
arratja	araatchie;araatje;arache;aratja;aratje;arraci;arratje
arratje	araatchie;araatje;arache;aratja;aratje;arraci;arratja
artillerie-handlanger	handlanger
asdsistent	absolut assistent;absoluut assistent;adsistend;adsistendt;adsistent;adssistent;adssitend;asiestend;asistent;assistant;assistant to the (chief) merchant;assistend;assistendt;assistent;merchant's assistant;schrijver
asiestend	absolut assistent;absoluut assistent;adsistend;adsistendt;adsistent;adssistent;adssitend;asdsistent;asistent;assistant;assistant to the (chief) merchant;assistend;assistendt;assistent;merchant's assistant;schrijver
asistent	absolut assistent;absoluut assistent;adsistend;adsistendt;adsistent;adssistent;adssitend;asdsistent;asiestend;assistant;assistant to the (chief) merchant;assistend;assistendt;assistent;merchant's assistant;schrijver
assistant	absolut assistent;absoluut assistent;adsistend;adsistendt;adsistent;adssistent;adssitend;asdsistent;asiestend;asistent;assistant to the (chief) merchant;assistend;assistendt;assistent;merchant's assistant;schrijver
assistant barber-surgeon	onderbarbier;second barber
assistant steward	botteliermaet;botteliersm:;botteliersmaat
assistant to the (chief) merchant	absolut assistent;absoluut assistent;adsistend;adsistendt;adsistent;adssistent;adssitend;asdsistent;asiestend;asistent;assistant;assistend;assistendt;assistent;merchant's assistant;schrijver
assistend	absolut assistent;absoluut assistent;adsistend;adsistendt;adsistent;adssistent;adssitend;asdsistent;asiestend;asistent;assistant;assistant to the (chief) merchant;assistendt;assistent;merchant's assistant;schrijver
assistendt	absolut assistent;absoluut assistent;adsistend;adsistendt;adsistent;adssistent;adssitend;asdsistent;asiestend;asistent;assistant;assistant to the (chief) merchant;assistend;assistent;merchant's assistant;schrijver
assistent	absolut assistent;absoluut assistent;adsistend;adsistendt;adsistent;adssistent;adssitend;asdsistent;asiestend;asistent;assistant;assistant to the (chief) merchant;assistend;assistendt;merchant's assistant;schrijver
baas der kruijtmakers	baas der kruitmakers;baas kruijtmaker
baas der kruitmakers	baas der kruijtmakers;baas kruijtmaker
baas der kuipers	first cooper;opperkuijper;opperkuiper
baas der pannebakkers	baas der pannenbakkers;pannebakker
baas der pannenbakkers	baas der pannebakkers;pannebakker
baas der scheepstimmerlieden	Baas Scheeps Timmerm;baas der scheepstimmermannen;baas der scheepstimmerwerf;baas der scheeptimmerlieden;baas der schipstimmerwerf;opperscheepstimmerman;senior ship carpenter
baas der scheepstimmermannen	Baas Scheeps Timmerm;baas der scheepstimmerlieden;baas der scheepstimmerwerf;baas der scheeptimmerlieden;baas der schipstimmerwerf;opperscheepstimmerman;senior ship carpenter
baas der scheepstimmerwerf	Baas Scheeps Timmerm;baas der scheepstimmerlieden;baas der scheepstimmermannen;baas der scheeptimmerlieden;baas der schipstimmerwerf;opperscheepstimmerman;senior ship carpenter
baas der scheeptimmerlieden	Baas Scheeps Timmerm;baas der scheepstimmerlieden;baas der scheepstimmermannen;baas der scheepstimmerwerf;baas der schipstimmerwerf;opperscheepstimmerman;senior ship carpenter
baas der schipstimmerwerf	Baas Scheeps Timmerm;baas der scheepstimmerlieden;baas der scheepstimmermannen;baas der scheepstimmerwerf;baas der scheeptimmerlieden;opperscheepstimmerman;senior ship carpenter
baas der smidswinkel	baas der smits;baes der smitswinkel
baas der smits	baas der smidswinkel;baes der smitswinkel
baas der timmermannen	oppertemmerman;oppertimmerman
baas kruijtmaker	baas der kruijtmakers;baas der kruitmakers
baas van de schutterije	capitain der burgereij;capitain der burgererije;capitain der burgerij;capitain der burgerije;capn: der burgerij;captain of the civic guard;kapitein der burgerij;kapitein der burgerije
baes der smitswinkel	baas der smidswinkel;baas der smits
bakkerin	bakkerinne
bakkerinne	bakkerin
bakmeester	baksmeester
baksmeester	bakmeester
balk meeter	balkmeter
balkmeter	balk meeter
barber-surgeon	barbier;first barber-surgeon
barberot	apprentice surgeon
barbier	barber-surgeon;first barber-surgeon
bedienaar der goddelijken woord	bedienaar der goddelijken woords;bedienaar des goddelijken woords;bedienaar des goddelijken woorts;bedienaar des godelijker woords;bedienaar des godelijkse woords;bedinaar des goddelijken woords;bedinaar des goddelijken woorts;bedinaar des goddelijks woorts;dominee;minister;predicant;predikant
bedienaar der goddelijken woords	bedienaar der goddelijken woord;bedienaar des goddelijken woords;bedienaar des goddelijken woorts;bedienaar des godelijker woords;bedienaar des godelijkse woords;bedinaar des goddelijken woords;bedinaar des goddelijken woorts;bedinaar des goddelijks woorts;dominee;minister;predicant;predikant
bedienaar des goddelijken woords	bedienaar der goddelijken woord;bedienaar der goddelijken woords;bedienaar des goddelijken woorts;bedienaar des godelijker woords;bedienaar des godelijkse woords;bedinaar des goddelijken woords;bedinaar des goddelijken woorts;bedinaar des goddelijks woorts;dominee;minister;predicant;predikant
bedienaar des goddelijken woorts	bedienaar der goddelijken woord;bedienaar der goddelijken woords;bedienaar des goddelijken woords;bedienaar des godelijker woords;bedienaar des godelijkse woords;bedinaar des goddelijken woords;bedinaar des goddelijken woorts;bedinaar des goddelijks woorts;dominee;minister;predicant;predikant
bedienaar des godelijker woords	bedienaar der goddelijken woord;bedienaar der goddelijken woords;bedienaar des goddelijken woords;bedienaar des goddelijken woorts;bedienaar des godelijkse woords;bedinaar des goddelijken woords;bedinaar des goddelijken woorts;bedinaar des goddelijks woorts;dominee;minister;predicant;predikant
bedienaar des godelijkse woords	bedienaar der goddelijken woord;bedienaar der goddelijken woords;bedienaar des goddelijken woords;bedienaar des goddelijken woorts;bedienaar des godelijker woords;bedinaar des goddelijken woords;bedinaar des goddelijken woorts;bedinaar des goddelijks woorts;dominee;minister;predicant;predikant
bedinaar des goddelijken woords	bedienaar der goddelijken woord;bedienaar der goddelijken woords;bedienaar des goddelijken woords;bedienaar des goddelijken woorts;bedienaar des godelijker woords;bedienaar des godelijkse woords;bedinaar des goddelijken woorts;bedinaar des goddelijks woorts;dominee;minister;predicant;predikant
bedinaar des goddelijken woorts	bedienaar der goddelijken woord;bedienaar der goddelijken woords;bedienaar des goddelijken woords;bedienaar des goddelijken woorts;bedienaar des godelijker woords;bedienaar des godelijkse woords;bedinaar des goddelijken woords;bedinaar des goddelijks woorts;dominee;minister;predicant;predikant
bedinaar des goddelijks woorts	bedienaar der goddelijken woord;bedienaar der goddelijken woords;bedienaar des goddelijken woords;bedienaar des goddelijken woorts;bedienaar des godelijker woords;bedienaar des godelijkse woords;bedinaar des goddelijken woords;bedinaar des goddelijken woorts;dominee;minister;predicant;predikant
belastingpachter	pachter;pagter
beul	scherprechter;scherpregter
biermaat	biermaet
biermaet	biermaat
binnen regent	binnenregent
binnenregent	binnen regent
blacksmith	grofsmit;grofsmith
blikjeager	blikslager;brass-founder
blikslager	blikjeager;brass-founder
block maker	blokemaker;blokenmaker
blokemaker	block maker;blokenmaker
blokenmaker	block maker;blokemaker
blokmaakers gesel	blokmakersgezel
blokmakersgezel	blokmaakers gesel
boatswain	boodsmaen;boodsman;boosman;boostman;bootsman;first boatswain;gegagieerd bootsman;hoog bootsman;hoogbootsman;loog bootsm:;oogbootsman
boatswain (foremast)	schieman;schiemand;tweede bootsman
boatswain's mate	boosmansmaet;bootsmanmaat;bootsmansmaat;first boatswain's mate;hoogbootsmansmaat
boatswain's mate (foremast)	schiemansmaat;schiemansmaet;schimansmaat;tweede schieman
bode	bood;boode
boekh:	boekhouden;boekouder;bookkeeper;boukhouder
boekhouden	boekh:;boekouder;bookkeeper;boukhouder
boekouder	boekh:;boekhouden;bookkeeper;boukhouder
bombaardier	bombardier;bombardir;bombardur
bombardier	bombaardier;bombardir;bombardur
bombardir	bombaardier;bombardier;bombardur
bombardur	bombaardier;bombardier;bombardir
bood	bode;boode
boode	bode;bood
boodsmaen	boatswain;boodsman;boosman;boostman;bootsman;first boatswain;gegagieerd bootsman;hoog bootsman;hoogbootsman;loog bootsm:;oogbootsman
boodsman	boatswain;boodsmaen;boosman;boostman;bootsman;first boatswain;gegagieerd bootsman;hoog bootsman;hoogbootsman;loog bootsm:;oogbootsman
bookkeeper	boekh:;boekhouden;boekouder;boukhouder
boomteler	boomteller
boomteller	boomteler
boorde	boorder;gegagieerden boorder
boorder	boorde;gegagieerden boorder
boormaker	drill maker
boosman	boatswain;boodsmaen;boodsman;boostman;bootsman;first boatswain;gegagieerd bootsman;hoog bootsman;hoogbootsman;loog bootsm:;oogbootsman
boosmansmaet	boatswain's mate;bootsmanmaat;bootsmansmaat;first boatswain's mate;hoogbootsmansmaat
boostman	boatswain;boodsmaen;boodsman;boosman;bootsman;first boatswain;gegagieerd bootsman;hoog bootsman;hoogbootsman;loog bootsm:;oogbootsman
bootsgesel	chinese seaman;seaman
bootsman	boatswain;boodsmaen;boodsman;boosman;boostman;first boatswain;gegagieerd bootsman;hoog bootsman;hoogbootsman;loog bootsm:;oogbootsman
bootsmanmaat	boatswain's mate;boosmansmaet;bootsmansmaat;first boatswain's mate;hoogbootsmansmaat
bootsmansmaat	boatswain's mate;boosmansmaet;bootsmanmaat;first boatswain's mate;hoogbootsmansmaat
boschieter	bosgieter;bosschier;bosschieter;bosschiter;busschieter
boschwachter	boswachter
bosgieter	boschieter;bosschier;bosschieter;bosschiter;busschieter
bosschier	boschieter;bosgieter;bosschieter;bosschiter;busschieter
bosschieter	boschieter;bosgieter;bosschier;bosschiter;busschieter
bosschiter	boschieter;bosgieter;bosschier;bosschieter;busschieter
bossemaker	bussemaker
boswachter	boschwachter
boswagters adjunct	adjunct-boswachter
botteliermaet	assistant steward;botteliersm:;botteliersmaat
botteliersm:	assistant steward;botteliermaet;botteliersmaat
botteliersmaat	assistant steward;botteliermaet;botteliersm:
boukhouder	boekh:;boekhouden;boekouder;bookkeeper
boy guard	cabin steward;junior steward;kajuitsjongen
brandspuitmaker	brandspuitslangenmaker;fire hose maker;manual fire engine maker
brandspuitslangenmaker	brandspuitmaker;fire hose maker;manual fire engine maker
brass-founder	blikjeager;blikslager
bricklayer	gegagieerden metselaar;metselaer
busschieter	boschieter;bosgieter;bosschier;bosschieter;bosschiter
bussemaker	bossemaker
cabin boy	jongen;ship's boy
cabin steward	boy guard;junior steward;kajuitsjongen
cabinet maker	kastenmaker;meubelmaker;schrijnwerker
cadet	cadet militair
cadet militair	cadet
caffer	casser;kaffer
cannanier	cannonir;cannonnier;canomien;canonier;canonnier;kananier;kanonier;kanonnier
cannonir	cannanier;cannonnier;canomien;canonier;canonnier;kananier;kanonier;kanonnier
cannonnier	cannanier;cannonir;canomien;canonier;canonnier;kananier;kanonier;kanonnier
canomien	cannanier;cannonir;cannonnier;canonier;canonnier;kananier;kanonier;kanonnier
canonier	cannanier;cannonir;cannonnier;canomien;canonnier;kananier;kanonier;kanonnier
canonnier	cannanier;cannonir;cannonnier;canomien;canonier;kananier;kanonier;kanonnier
cap:	capetain;capetijn der militaijre;capitaijn;capitain;capitain commandant;capitain der militie;capitain miliair;capitain militair;capiteijn;capitein;capiteinn;capitijn;cappitain;capt:;captain;captain (military);captain der militie;captijn;kapitain;kapitijn
capetain	cap:;capetijn der militaijre;capitaijn;capitain;capitain commandant;capitain der militie;capitain miliair;capitain militair;capiteijn;capitein;capiteinn;capitijn;cappitain;capt:;captain;captain (military);captain der militie;captijn;kapitain;kapitijn
capetijn der militaijre	cap:;capetain;capitaijn;capitain;capitain commandant;capitain der militie;capitain miliair;capitain militair;capiteijn;capitein;capiteinn;capitijn;cappitain;capt:;captain;captain (military);captain der militie;captijn;kapitain;kapitijn
capitaijn	cap:;capetain;capetijn der militaijre;capitain;capitain commandant;capitain der militie;capitain miliair;capitain militair;capiteijn;capitein;capiteinn;capitijn;cappitain;capt:;captain;captain (military);captain der militie;captijn;kapitain;kapitijn
capitain	cap:;capetain;capetijn der militaijre;capitaijn;capitain commandant;capitain der militie;capitain miliair;capitain militair;capiteijn;capitein;capiteinn;capitijn;cappitain;capt:;captain;captain (military);captain der militie;captijn;kapitain;kapitijn
capitain commandant	cap:;capetain;capetijn der militaijre;capitaijn;capitain;capitain der militie;capitain miliair;capitain militair;capiteijn;capitein;capiteinn;capitijn;cappitain;capt:;captain;captain (military);captain der militie;captijn;kapitain;kapitijn
capitain der burgereij	baas van de schutterije;capitain der burgererije;capitain der burgerij;capitain der burgerije;capn: der burgerij;captain of the civic guard;kapitein der burgerij;kapitein der burgerije
capitain der burgererije	baas van de schutterije;capitain der burgereij;capitain der burgerij;capitain der burgerije;capn: der burgerij;captain of the civic guard;kapitein der burgerij;kapitein der burgerije
capitain der burgerij	baas van de schutterije;capitain der burgereij;capitain der burgererije;capitain der burgerije;capn: der burgerij;captain of the civic guard;kapitein der burgerij;kapitein der burgerije
capitain der burgerije	baas van de schutterije;capitain der burgereij;capitain der burgererije;capitain der burgerij;capn: der burgerij;captain of the civic guard;kapitein der burgerij;kapitein der burgerije
capitain der militie	cap:;capetain;capetijn der militaijre;capitaijn;capitain;capitain commandant;capitain miliair;capitain militair;capiteijn;capitein;capiteinn;capitijn;cappitain;capt:;captain;captain (military);captain der militie;captijn;kapitain;kapitijn
capitain leuijtenant	capitain leytenant;capitain lieutenant;capitain lieutenant van de militie;capitain luijtenant;capitain luijtenant der militie;capitain luijtenant militair;capitain luitenant;capiteijn luijtenand;capitein lieutenant;capitein luijtenant der militair;capitein luijtenant der militia;capitein luijtenant der militie;kapitein luitenant;kapitein-luitenant
capitain leytenant	capitain leuijtenant;capitain lieutenant;capitain lieutenant van de militie;capitain luijtenant;capitain luijtenant der militie;capitain luijtenant militair;capitain luitenant;capiteijn luijtenand;capitein lieutenant;capitein luijtenant der militair;capitein luijtenant der militia;capitein luijtenant der militie;kapitein luitenant;kapitein-luitenant
capitain lieutenant	capitain leuijtenant;capitain leytenant;capitain lieutenant van de militie;capitain luijtenant;capitain luijtenant der militie;capitain luijtenant militair;capitain luitenant;capiteijn luijtenand;capitein lieutenant;capitein luijtenant der militair;capitein luijtenant der militia;capitein luijtenant der militie;kapitein luitenant;kapitein-luitenant
capitain lieutenant van de militie	capitain leuijtenant;capitain leytenant;capitain lieutenant;capitain luijtenant;capitain luijtenant der militie;capitain luijtenant militair;capitain luitenant;capiteijn luijtenand;capitein lieutenant;capitein luijtenant der militair;capitein luijtenant der militia;capitein luijtenant der militie;kapitein luitenant;kapitein-luitenant
capitain luijtenant	capitain leuijtenant;capitain leytenant;capitain lieutenant;capitain lieutenant van de militie;capitain luijtenant der militie;capitain luijtenant militair;capitain luitenant;capiteijn luijtenand;capitein lieutenant;capitein luijtenant der militair;capitein luijtenant der militia;capitein luijtenant der militie;kapitein luitenant;kapitein-luitenant
capitain luijtenant der militie	capitain leuijtenant;capitain leytenant;capitain lieutenant;capitain lieutenant van de militie;capitain luijtenant;capitain luijtenant militair;capitain luitenant;capiteijn luijtenand;capitein lieutenant;capitein luijtenant der militair;capitein luijtenant der militia;capitein luijtenant der militie;kapitein luitenant;kapitein-luitenant
capitain luijtenant militair	capitain leuijtenant;capitain leytenant;capitain lieutenant;capitain lieutenant van de militie;capitain luijtenant;capitain luijtenant der militie;capitain luitenant;capiteijn luijtenand;capitein lieutenant;capitein luijtenant der militair;capitein luijtenant der militia;capitein luijtenant der militie;kapitein luitenant;kapitein-luitenant
capitain luitenant	capitain leuijtenant;capitain leytenant;capitain lieutenant;capitain lieutenant van de militie;capitain luijtenant;capitain luijtenant der militie;capitain luijtenant militair;capiteijn luijtenand;capitein lieutenant;capitein luijtenant der militair;capitein luijtenant der militia;capitein luijtenant der militie;kapitein luitenant;kapitein-luitenant
capitain miliair	cap:;capetain;capetijn der militaijre;capitaijn;capitain;capitain commandant;capitain der militie;capitain militair;capiteijn;capitein;capiteinn;capitijn;cappitain;capt:;captain;captain (military);captain der militie;captijn;kapitain;kapitijn
capitain militair	cap:;capetain;capetijn der militaijre;capitaijn;capitain;capitain commandant;capitain der militie;capitain miliair;capiteijn;capitein;capiteinn;capitijn;cappitain;capt:;captain;captain (military);captain der militie;captijn;kapitain;kapitijn
capiteijn	cap:;capetain;capetijn der militaijre;capitaijn;capitain;capitain commandant;capitain der militie;capitain miliair;capitain militair;capitein;capiteinn;capitijn;cappitain;capt:;captain;captain (military);captain der militie;captijn;kapitain;kapitijn
capiteijn luijtenand	capitain leuijtenant;capitain leytenant;capitain lieutenant;capitain lieutenant van de militie;capitain luijtenant;capitain luijtenant der militie;capitain luijtenant militair;capitain luitenant;capitein lieutenant;capitein luijtenant der militair;capitein luijtenant der militia;capitein luijtenant der militie;kapitein luitenant;kapitein-luitenant
capitein	cap:;capetain;capetijn der militaijre;capitaijn;capitain;capitain commandant;capitain der militie;capitain miliair;capitain militair;capiteijn;capiteinn;capitijn;cappitain;capt:;captain;captain (military);captain der militie;captijn;kapitain;kapitijn
capitein lieutenant	capitain leuijtenant;capitain leytenant;capitain lieutenant;capitain lieutenant van de militie;capitain luijtenant;capitain luijtenant der militie;capitain luijtenant militair;capitain luitenant;capiteijn luijtenand;capitein luijtenant der militair;capitein luijtenant der militia;capitein luijtenant der militie;kapitein luitenant;kapitein-luitenant
capitein luijtenant der militair	capitain leuijtenant;capitain leytenant;capitain lieutenant;capitain lieutenant van de militie;capitain luijtenant;capitain luijtenant der militie;capitain luijtenant militair;capitain luitenant;capiteijn luijtenand;capitein lieutenant;capitein luijtenant der militia;capitein luijtenant der militie;kapitein luitenant;kapitein-luitenant
capitein luijtenant der militia	capitain leuijtenant;capitain leytenant;capitain lieutenant;capitain lieutenant van de militie;capitain luijtenant;capitain luijtenant der militie;capitain luijtenant militair;capitain luitenant;capiteijn luijtenand;capitein lieutenant;capitein luijtenant der militair;capitein luijtenant der militie;kapitein luitenant;kapitein-luitenant
capitein luijtenant der militie	capitain leuijtenant;capitain leytenant;capitain lieutenant;capitain lieutenant van de militie;capitain luijtenant;capitain luijtenant der militie;capitain luijtenant militair;capitain luitenant;capiteijn luijtenand;capitein lieutenant;capitein luijtenant der militair;capitein luijtenant der militia;kapitein luitenant;kapitein-luitenant
capiteinn	cap:;capetain;capetijn der militaijre;capitaijn;capitain;capitain commandant;capitain der militie;capitain miliair;capitain militair;capiteijn;capitein;capitijn;cappitain;capt:;captain;captain (military);captain der militie;captijn;kapitain;kapitijn
capitijn	cap:;capetain;capetijn der militaijre;capitaijn;capitain;capitain commandant;capitain der militie;capitain miliair;capitain militair;capiteijn;capitein;capiteinn;cappitain;capt:;captain;captain (military);captain der militie;captijn;kapitain;kapitijn
capn: der burgerij	baas van de schutterije;capitain der burgereij;capitain der burgererije;capitain der burgerij;capitain der burgerije;captain of the civic guard;kapitein der burgerij;kapitein der burgerije
cappitain	cap:;capetain;capetijn der militaijre;capitaijn;capitain;capitain commandant;capitain der militie;capitain miliair;capitain militair;capiteijn;capitein;capiteinn;capitijn;capt:;captain;captain (military);captain der militie;captijn;kapitain;kapitijn
capt:	cap:;capetain;capetijn der militaijre;capitaijn;capitain;capitain commandant;capitain der militie;capitain miliair;capitain militair;capiteijn;capitein;capiteinn;capitijn;cappitain;captain;captain (military);captain der militie;captijn;kapitain;kapitijn
captain	cap:;capetain;capetijn der militaijre;capitaijn;capitain;capitain commandant;capitain der militie;capitain miliair;capitain militair;capiteijn;capitein;capiteinn;capitijn;cappitain;capt:;captain (military);captain der militie;captijn;kapitain;kapitijn
captain (military)	cap:;capetain;capetijn der militaijre;capitaijn;capitain;capitain commandant;capitain der militie;capitain miliair;capitain militair;capiteijn;capitein;capiteinn;capitijn;cappitain;capt:;captain;captain der militie;captijn;kapitain;kapitijn
captain der militie	cap:;capetain;capetijn der militaijre;capitaijn;capitain;capitain commandant;capitain der militie;capitain miliair;capitain militair;capiteijn;capitein;capiteinn;capitijn;cappitain;capt:;captain;captain (military);captijn;kapitain;kapitijn
captain of the civic guard	baas van de schutterije;capitain der burgereij;capitain der burgererije;capitain der burgerij;capitain der burgerije;capn: der burgerij;kapitein der burgerij;kapitein der burgerije
captijn	cap:;capetain;capetijn der militaijre;capitaijn;capitain;capitain commandant;capitain der militie;capitain miliair;capitain militair;capiteijn;capitein;capiteinn;capitijn;cappitain;capt:;captain;captain (military);captain der militie;kapitain;kapitijn
carga	supercarga;supercargo;supperc:;suppercarga
cartemaker	kaartmaker;map maker;mapmaker
cartwright	waagemaaker;waagemaker;wagemaaker;wagemaker
cassanar	cassenairo;catenaar;cattenaar;cattenar;kattanar
cassenairo	cassanar;catenaar;cattenaar;cattenar;kattanar
casser	caffer;kaffer
cassier	kasier;kassier
catenaar	cassanar;cassenairo;cattenaar;cattenar;kattanar
cattenaar	cassanar;cassenairo;catenaar;cattenar;kattanar
cattenar	cassanar;cassenairo;catenaar;cattenaar;kattanar
cavalry captain	ritmeester
cepier	ciepier;cipier;siepier;sipier
chief merchant	opper koopman;oppercoopman;senior merchant
chief sailmaker	opperceijlmaaker;opperseijlmaker;opperzeilmaker;senior sail maker
chinese seaman	bootsgesel;seaman
chirugijn	chirurgeijn;chrirugijn;churugeijn;chururgijn;meester;sirurgeijn;surgeon
chirurgeijn	chirugijn;chrirugijn;churugeijn;chururgijn;meester;sirurgeijn;surgeon
chrirugijn	chirugijn;chirurgeijn;churugeijn;chururgijn;meester;sirurgeijn;surgeon
churugeijn	chirugijn;chirurgeijn;chrirugijn;chururgijn;meester;sirurgeijn;surgeon
chururgijn	chirugijn;chirurgeijn;chrirugijn;churugeijn;meester;sirurgeijn;surgeon
ciepier	cepier;cipier;siepier;sipier
cipier	cepier;ciepier;siepier;sipier
clercq	clerq;geswoore clerq van politie;geswore clerk van politie;gesworen clerq;klerk;klerq
clerq	clercq;geswoore clerq van politie;geswore clerk van politie;gesworen clerq;klerk;klerq
command:	commandaent ;commandanr;commandant;commander ;commander of the soldiers;commandt:;kommandant
commandaent 	command:;commandanr;commandant;commander ;commander of the soldiers;commandt:;kommandant
commandanr	command:;commandaent ;commandant;commander ;commander of the soldiers;commandt:;kommandant
commandant	command:;commandaent ;commandanr;commander ;commander of the soldiers;commandt:;kommandant
commander 	command:;commandaent ;commandanr;commandant;commander of the soldiers;commandt:;kommandant
commander colonel	kolonel-commandant
commander of the soldiers	command:;commandaent ;commandanr;commandant;commander ;commandt:;kommandant
commandt:	command:;commandaent ;commandanr;commandant;commander ;commander of the soldiers;kommandant
commies	coopman;koopm:;merchant
commisiart	commissiant;committeerder;gecommitteerde
commissiant	commisiart;committeerder;gecommitteerde
committeerder	commisiart;commissiant;gecommitteerde
comsumptie boekhouder	consumptie boekhouder;consumptieboekhouder;consumtiehouder ;conzumptie boekhouder;conzumtie boekhouder
constabel	constapel;gunner;weapons master
constabelsmaet	constapelsmaat;constapelsmaet;konstabelsmaat;weapons-master's mate
constapel	constabel;gunner;weapons master
constapelsmaat	constabelsmaet;constapelsmaet;konstabelsmaat;weapons-master's mate
constapelsmaet	constabelsmaet;constapelsmaat;konstabelsmaat;weapons-master's mate
consumptie boekhouder	comsumptie boekhouder;consumptieboekhouder;consumtiehouder ;conzumptie boekhouder;conzumtie boekhouder
consumptieboekhouder	comsumptie boekhouder;consumptie boekhouder;consumtiehouder ;conzumptie boekhouder;conzumtie boekhouder
consumtiehouder 	comsumptie boekhouder;consumptie boekhouder;consumptieboekhouder;conzumptie boekhouder;conzumtie boekhouder
conzumptie boekhouder	comsumptie boekhouder;consumptie boekhouder;consumptieboekhouder;consumtiehouder ;conzumtie boekhouder
conzumtie boekhouder	comsumptie boekhouder;consumptie boekhouder;consumptieboekhouder;consumtiehouder ;conzumptie boekhouder
cook	kock;koek
cook's mate	kokmaet
cooper	cuijper;kuijper
coopman	commies;koopm:;merchant
coorporaal	copraal;corp:;corpaal;corparal;corperaal;corperal;corpolral;corpor:;corporaal;corporaar;corporael;corporal;corporâl;gegagieerden korporaal;koporaal;korperaal;korporael
copper-smith	koperslager
copraal	coorporaal;corp:;corpaal;corparal;corperaal;corperal;corpolral;corpor:;corporaal;corporaar;corporael;corporal;corporâl;gegagieerden korporaal;koporaal;korperaal;korporael
corp:	coorporaal;copraal;corpaal;corparal;corperaal;corperal;corpolral;corpor:;corporaal;corporaar;corporael;corporal;corporâl;gegagieerden korporaal;koporaal;korperaal;korporael
corpaal	coorporaal;copraal;corp:;corparal;corperaal;corperal;corpolral;corpor:;corporaal;corporaar;corporael;corporal;corporâl;gegagieerden korporaal;koporaal;korperaal;korporael
corparal	coorporaal;copraal;corp:;corpaal;corperaal;corperal;corpolral;corpor:;corporaal;corporaar;corporael;corporal;corporâl;gegagieerden korporaal;koporaal;korperaal;korporael
corperaal	coorporaal;copraal;corp:;corpaal;corparal;corperal;corpolral;corpor:;corporaal;corporaar;corporael;corporal;corporâl;gegagieerden korporaal;koporaal;korperaal;korporael
corperal	coorporaal;copraal;corp:;corpaal;corparal;corperaal;corpolral;corpor:;corporaal;corporaar;corporael;corporal;corporâl;gegagieerden korporaal;koporaal;korperaal;korporael
corpolral	coorporaal;copraal;corp:;corpaal;corparal;corperaal;corperal;corpor:;corporaal;corporaar;corporael;corporal;corporâl;gegagieerden korporaal;koporaal;korperaal;korporael
corpor:	coorporaal;copraal;corp:;corpaal;corparal;corperaal;corperal;corpolral;corporaal;corporaar;corporael;corporal;corporâl;gegagieerden korporaal;koporaal;korperaal;korporael
corporaal	coorporaal;copraal;corp:;corpaal;corparal;corperaal;corperal;corpolral;corpor:;corporaar;corporael;corporal;corporâl;gegagieerden korporaal;koporaal;korperaal;korporael
corporaar	coorporaal;copraal;corp:;corpaal;corparal;corperaal;corperal;corpolral;corpor:;corporaal;corporael;corporal;corporâl;gegagieerden korporaal;koporaal;korperaal;korporael
corporael	coorporaal;copraal;corp:;corpaal;corparal;corperaal;corperal;corpolral;corpor:;corporaal;corporaar;corporal;corporâl;gegagieerden korporaal;koporaal;korperaal;korporael
corporal	coorporaal;copraal;corp:;corpaal;corparal;corperaal;corperal;corpolral;corpor:;corporaal;corporaar;corporael;corporâl;gegagieerden korporaal;koporaal;korperaal;korporael
corporâl	coorporaal;copraal;corp:;corpaal;corparal;corperaal;corperal;corpolral;corpor:;corporaal;corporaar;corporael;corporal;gegagieerden korporaal;koporaal;korperaal;korporael
coster	joster;koster
council of justice	lid van de Raad van Justitie
cuijper	cooper;kuijper
derde barbier	third barber-surgeon
derde meester	derde neester;derden meester;third surgeon
derde neester	derde meester;derden meester;third surgeon
derde stuurman	derde waak;derdewaak;derdewaek;hulpstuurman;third mate
derde waak	derde stuurman;derdewaak;derdewaek;hulpstuurman;third mate
derden meester	derde meester;derde neester;third surgeon
derdewaak	derde stuurman;derde waak;derdewaek;hulpstuurman;third mate
derdewaek	derde stuurman;derde waak;derdewaak;hulpstuurman;third mate
diespencier	dispencier;dispensier
directeur	direkteur
direkteur	directeur
dispencier	diespencier;dispensier
dispensier	diespencier;dispencier
docent	Inlands leermeester;leermeester;meester
docter	doctor;dokter
doctor	docter;dokter
dokter	docter;doctor
dominee	bedienaar der goddelijken woord;bedienaar der goddelijken woords;bedienaar des goddelijken woords;bedienaar des goddelijken woorts;bedienaar des godelijker woords;bedienaar des godelijkse woords;bedinaar des goddelijken woords;bedinaar des goddelijken woorts;bedinaar des goddelijks woorts;minister;predicant;predikant
drill maker	boormaker
drummer	trommelaar;trommelslager
eerste lanspassaat	first lance corporal
eerste luitenant	premier luitenant
eerste onderchirurgijn	first assistant surgeon
eerste stuurman	first mate;luitenant (zeeman);opperstuurman
ensign	ensign bearer;standard-bearer;vaanderig;vaandrich ;vaendrig;vandrig;vandrigt;vendrig ;viendrig
ensign bearer	ensign;standard-bearer;vaanderig;vaandrich ;vaendrig;vandrig;vandrigt;vendrig ;viendrig
equipagemeester	Equipagemaster;equipagie meester;equipagiemeester;equipasie opziender
equipagie meester	Equipagemaster;equipagemeester;equipagiemeester;equipasie opziender
equipagiemeester	Equipagemaster;equipagemeester;equipagie meester;equipasie opziender
equipasie opziender	Equipagemaster;equipagemeester;equipagie meester;equipagiemeester
extra ord:	extra ordenarie;extra ordinair ;extraordinaris
extra ordenarie	extra ord:;extra ordinair ;extraordinaris
extra ordinair 	extra ord:;extra ordenarie;extraordinaris
extraordinaris	extra ord:;extra ordenarie;extra ordinair 
extraordinaris raedt van india	Raad van Indië;Raad van Nederlandse India;lid van de Raad van Indië;raad extra ordinair van India 
fire hose maker	brandspuitmaker;brandspuitslangenmaker;manual fire engine maker
first assistant surgeon	eerste onderchirurgijn
first barber-surgeon	barber-surgeon;barbier
first boatswain	boatswain;boodsmaen;boodsman;boosman;boostman;bootsman;gegagieerd bootsman;hoog bootsman;hoogbootsman;loog bootsm:;oogbootsman
first boatswain's mate	boatswain's mate;boosmansmaet;bootsmanmaat;bootsmansmaat;hoogbootsmansmaat
first cooper	baas der kuipers;opperkuijper;opperkuiper
first lance corporal	eerste lanspassaat
first mate	eerste stuurman;luitenant (zeeman);opperstuurman
first supervisor of Asian crew members	oppermandoor;oppermandor
fiscaal	fiscael;fiskaal;prosecutor
fiscael	fiscaal;fiskaal;prosecutor
fiskaal	fiscaal;fiscael;prosecutor
fluiter	peijper;piper
fourier	officer responsible for provisioning of soldiers;quartermaster
g'gagieerde	g'gagieerden;gegadieerden ;gegadjieerden ;gegageerde;gegageerden;gegagieerde;gegagieerden ;gegagieerdens ;gegasieerde 
g'gagieerden	g'gagieerde;gegadieerden ;gegadjieerden ;gegageerde;gegageerden;gegagieerde;gegagieerden ;gegagieerdens ;gegasieerde 
garnisoenschrijver	garnizoenschrijver;guarnesoen schrijver;guarni soen schrijver;guarniesoen schrijver;guarnisoen schrijver;guarnisoenschrijver;guarrisoen schrijver;quarnisoenschrijver
garnizoenschrijver	garnisoenschrijver;guarnesoen schrijver;guarni soen schrijver;guarniesoen schrijver;guarnisoen schrijver;guarnisoenschrijver;guarrisoen schrijver;quarnisoenschrijver
geauthoriseerde	geautoriseerde
geautoriseerde	geauthoriseerde
gecommitteerde	commisiart;commissiant;committeerder
gegadieerden 	g'gagieerde;g'gagieerden;gegadjieerden ;gegageerde;gegageerden;gegagieerde;gegagieerden ;gegagieerdens ;gegasieerde 
gegadjieerden 	g'gagieerde;g'gagieerden;gegadieerden ;gegageerde;gegageerden;gegagieerde;gegagieerden ;gegagieerdens ;gegasieerde 
gegageerde	g'gagieerde;g'gagieerden;gegadieerden ;gegadjieerden ;gegageerden;gegagieerde;gegagieerden ;gegagieerdens ;gegasieerde 
gegageerden	g'gagieerde;g'gagieerden;gegadieerden ;gegadjieerden ;gegageerde;gegagieerde;gegagieerden ;gegagieerdens ;gegasieerde 
gegagieerd bootsman	boatswain;boodsmaen;boodsman;boosman;boostman;bootsman;first boatswain;hoog bootsman;hoogbootsman;loog bootsm:;oogbootsman
gegagieerd sergeant	orderserjant;segeant;sergeant;sergiaant;sergiaent;sergiand;sergiant;serginat;sergt:;serishant;serjant;zergeant;zergiand;zergiant;zergt:
gegagieerde	g'gagieerde;g'gagieerden;gegadieerden ;gegadjieerden ;gegageerde;gegageerden;gegagieerden ;gegagieerdens ;gegasieerde 
gegagieerde soldaat	gemene;soldaaat;soldaar;soldaet;soldat;soldier;solt:;zoldaat;zoldaet;zoldt:
gegagieerden 	g'gagieerde;g'gagieerden;gegadieerden ;gegadjieerden ;gegageerde;gegageerden;gegagieerde;gegagieerdens ;gegasieerde 
gegagieerden boorder	boorde;boorder
gegagieerden korporaal	coorporaal;copraal;corp:;corpaal;corparal;corperaal;corperal;corpolral;corpor:;corporaal;corporaar;corporael;corporal;corporâl;koporaal;korperaal;korporael
gegagieerden metselaar	bricklayer;metselaer
gegagieerdens 	g'gagieerde;g'gagieerden;gegadieerden ;gegadjieerden ;gegageerde;gegageerden;gegagieerde;gegagieerden ;gegasieerde 
gegasieerde 	g'gagieerde;g'gagieerden;gegadieerden ;gegadjieerden ;gegageerde;gegageerden;gegagieerde;gegagieerden ;gegagieerdens 
gemene	gegagieerde soldaat;soldaaat;soldaar;soldaet;soldat;soldier;solt:;zoldaat;zoldaet;zoldt:
gerechtsbode	gerechtsboode;geregsboode;geregts-boode;geregtsbode;geregtsbood;geregtsboode
gerechtsboode	gerechtsbode;geregsboode;geregts-boode;geregtsbode;geregtsbood;geregtsboode
geregsboode	gerechtsbode;gerechtsboode;geregts-boode;geregtsbode;geregtsbood;geregtsboode
geregts-boode	gerechtsbode;gerechtsboode;geregsboode;geregtsbode;geregtsbood;geregtsboode
geregtsbode	gerechtsbode;gerechtsboode;geregsboode;geregts-boode;geregtsbood;geregtsboode
geregtsbood	gerechtsbode;gerechtsboode;geregsboode;geregts-boode;geregtsbode;geregtsboode
geregtsboode	gerechtsbode;gerechtsboode;geregsboode;geregts-boode;geregtsbode;geregtsbood
gesaghebber	gezaghebber
geswoore clerq van politie	clercq;clerq;geswore clerk van politie;gesworen clerq;klerk;klerq
geswore clerk van politie	clercq;clerq;geswoore clerq van politie;gesworen clerq;klerk;klerq
gesworen clerq	clercq;clerq;geswoore clerq van politie;geswore clerk van politie;klerk;klerq
geweldige	geweldige provoost;geweldiger;gewelliger;provoost geweldige
geweldige provoost	geweldige;geweldiger;gewelliger;provoost geweldige
geweldiger	geweldige;geweldige provoost;gewelliger;provoost geweldige
gewelliger	geweldige;geweldige provoost;geweldiger;provoost geweldige
gezaghebber	gesaghebber
gezagvoerder	schipheer;schipper
glaasemaker	glaesemaker;glaesmaeker;glase maker;glasemaaker;glasemaker;glasemakter;glasenmaker;glass maker;glazemaker;glazenmaker
glaesemaker	glaasemaker;glaesmaeker;glase maker;glasemaaker;glasemaker;glasemakter;glasenmaker;glass maker;glazemaker;glazenmaker
glaesmaeker	glaasemaker;glaesemaker;glase maker;glasemaaker;glasemaker;glasemakter;glasenmaker;glass maker;glazemaker;glazenmaker
glase maker	glaasemaker;glaesemaker;glaesmaeker;glasemaaker;glasemaker;glasemakter;glasenmaker;glass maker;glazemaker;glazenmaker
glasemaaker	glaasemaker;glaesemaker;glaesmaeker;glase maker;glasemaker;glasemakter;glasenmaker;glass maker;glazemaker;glazenmaker
glasemaker	glaasemaker;glaesemaker;glaesmaeker;glase maker;glasemaaker;glasemakter;glasenmaker;glass maker;glazemaker;glazenmaker
glasemakter	glaasemaker;glaesemaker;glaesmaeker;glase maker;glasemaaker;glasemaker;glasenmaker;glass maker;glazemaker;glazenmaker
glasenmaker	glaasemaker;glaesemaker;glaesmaeker;glase maker;glasemaaker;glasemaker;glasemakter;glass maker;glazemaker;glazenmaker
glass maker	glaasemaker;glaesemaker;glaesmaeker;glase maker;glasemaaker;glasemaker;glasemakter;glasenmaker;glazemaker;glazenmaker
glazemaker	glaasemaker;glaesemaker;glaesmaeker;glase maker;glasemaaker;glasemaker;glasemakter;glasenmaker;glass maker;glazenmaker
glazenmaker	glaasemaker;glaesemaker;glaesmaeker;glase maker;glasemaaker;glasemaker;glasemakter;glasenmaker;glass maker;glazemaker
goerip	guripo;kurup
goeverneur	gouverneur
gouverneur	goeverneur
gouverneur-generaal	acting governor-general;governor general
governor general	acting governor-general;gouverneur-generaal
grofsmit	blacksmith;grofsmith
grofsmith	blacksmith;grofsmit
guarnesoen schrijver	garnisoenschrijver;garnizoenschrijver;guarni soen schrijver;guarniesoen schrijver;guarnisoen schrijver;guarnisoenschrijver;guarrisoen schrijver;quarnisoenschrijver
guarni soen schrijver	garnisoenschrijver;garnizoenschrijver;guarnesoen schrijver;guarniesoen schrijver;guarnisoen schrijver;guarnisoenschrijver;guarrisoen schrijver;quarnisoenschrijver
guarniesoen schrijver	garnisoenschrijver;garnizoenschrijver;guarnesoen schrijver;guarni soen schrijver;guarnisoen schrijver;guarnisoenschrijver;guarrisoen schrijver;quarnisoenschrijver
guarnisoen schrijver	garnisoenschrijver;garnizoenschrijver;guarnesoen schrijver;guarni soen schrijver;guarniesoen schrijver;guarnisoenschrijver;guarrisoen schrijver;quarnisoenschrijver
guarnisoenschrijver	garnisoenschrijver;garnizoenschrijver;guarnesoen schrijver;guarni soen schrijver;guarniesoen schrijver;guarnisoen schrijver;guarrisoen schrijver;quarnisoenschrijver
guarrisoen schrijver	garnisoenschrijver;garnizoenschrijver;guarnesoen schrijver;guarni soen schrijver;guarniesoen schrijver;guarnisoen schrijver;guarnisoenschrijver;quarnisoenschrijver
gunner	constabel;constapel;weapons master
guripo	goerip;kurup
halfwaak	apprentice helmsman
handlanger	artillerie-handlanger
herbergier	kastelein;waard
hoofd	hooft
hoofd administrateur	hoofd-administrateur;hoofdadministrateur;koopadministrateur;secund;secunde;sekunde
hoofd der militie	hoofd van de militie
hoofd van de artillerie	kommandant der artillerie
hoofd van de militie	hoofd der militie
hoofd-administrateur	hoofd administrateur;hoofdadministrateur;koopadministrateur;secund;secunde;sekunde
hoofdadministrateur	hoofd administrateur;hoofd-administrateur;koopadministrateur;secund;secunde;sekunde
hooft	hoofd
hoog bootsman	boatswain;boodsmaen;boodsman;boosman;boostman;bootsman;first boatswain;gegagieerd bootsman;hoogbootsman;loog bootsm:;oogbootsman
hoogbootsman	boatswain;boodsmaen;boodsman;boosman;boostman;bootsman;first boatswain;gegagieerd bootsman;hoog bootsman;loog bootsm:;oogbootsman
hoogbootsmansmaat	boatswain's mate;boosmansmaet;bootsmanmaat;bootsmansmaat;first boatswain's mate
hoogloper	hooplooper;jong matroos;jongmatroos;junior sailor;juniormatroos;oploper
hooplooper	hoogloper;jong matroos;jongmatroos;junior sailor;juniormatroos;oploper
hospitaalmeester	hospitalier
hospitalier	hospitaalmeester
houdvester	houtvester
house carpenter	huijs timmerman;huijstimmerman
houtvester	houdvester
huijs timmerman	house carpenter;huijstimmerman
huijstimmerman	house carpenter;huijs timmerman
hulpstuurman	derde stuurman;derde waak;derdewaak;derdewaek;third mate
husaar	huzaar
huzaar	husaar
infirmary visitor	krankbesoeker;krankbezoeker;lekelezer;ziekenbezoeker
instrument maker	instrumentmaker
instrumentmaker	instrument maker
jo: adsistend	Jong assistent;jo: assistent;jong adsistend;jong koopmansassistent;jongen adsistent;junior assistant to the (chief) merchant;junior merchants assistant
jo: assistent	Jong assistent;jo: adsistend;jong adsistend;jong koopmansassistent;jongen adsistent;junior assistant to the (chief) merchant;junior merchants assistant
jong adsistend	Jong assistent;jo: adsistend;jo: assistent;jong koopmansassistent;jongen adsistent;junior assistant to the (chief) merchant;junior merchants assistant
jong koopmansassistent	Jong assistent;jo: adsistend;jo: assistent;jong adsistend;jongen adsistent;junior assistant to the (chief) merchant;junior merchants assistant
jong matroos	hoogloper;hooplooper;jongmatroos;junior sailor;juniormatroos;oploper
jong tolk	Jo: assistent bij den oppertolk
jongchirurgijn	young surgeon
jongen	cabin boy;ship's boy
jongen adsistent	Jong assistent;jo: adsistend;jo: assistent;jong adsistend;jong koopmansassistent;junior assistant to the (chief) merchant;junior merchants assistant
jongmatroos	hoogloper;hooplooper;jong matroos;junior sailor;juniormatroos;oploper
joster	coster;koster
junior assistant to the (chief) merchant	Jong assistent;jo: adsistend;jo: assistent;jong adsistend;jong koopmansassistent;jongen adsistent;junior merchants assistant
junior barber-surgeon	junior barbier
junior barbier	junior barber-surgeon
junior merchant	ondercoop:;ondercoopan;ondercoopman;onderkoomman;onderkoopman;onderokoopman
junior merchants assistant	Jong assistent;jo: adsistend;jo: assistent;jong adsistend;jong koopmansassistent;jongen adsistent;junior assistant to the (chief) merchant
junior ordinary seaman	junior seaman
junior sail maker	junior zeilmaker
junior sailor	hoogloper;hooplooper;jong matroos;jongmatroos;juniormatroos;oploper
junior seaman	junior ordinary seaman
junior steward	boy guard;cabin steward;kajuitsjongen
junior zeilmaker	junior sail maker
juniormatroos	hoogloper;hooplooper;jong matroos;jongmatroos;junior sailor;oploper
kaartmaker	cartemaker;map maker;mapmaker
kaffer	caffer;casser
kajuitsjongen	boy guard;cabin steward;junior steward
kananier	cannanier;cannonir;cannonnier;canomien;canonier;canonnier;kanonier;kanonnier
kanonier	cannanier;cannonir;cannonnier;canomien;canonier;canonnier;kananier;kanonnier
kanonnier	cannanier;cannonir;cannonnier;canomien;canonier;canonnier;kananier;kanonier
kapitain	cap:;capetain;capetijn der militaijre;capitaijn;capitain;capitain commandant;capitain der militie;capitain miliair;capitain militair;capiteijn;capitein;capiteinn;capitijn;cappitain;capt:;captain;captain (military);captain der militie;captijn;kapitijn
kapitain des armens	kapitain des arment;kapitain des armes;kapitain des arms;kapitein des armes
kapitain des arment	kapitain des armens;kapitain des armes;kapitain des arms;kapitein des armes
kapitain des armes	kapitain des armens;kapitain des arment;kapitain des arms;kapitein des armes
kapitain des arms	kapitain des armens;kapitain des arment;kapitain des armes;kapitein des armes
kapitein der burgerij	baas van de schutterije;capitain der burgereij;capitain der burgererije;capitain der burgerij;capitain der burgerije;capn: der burgerij;captain of the civic guard;kapitein der burgerije
kapitein der burgerije	baas van de schutterije;capitain der burgereij;capitain der burgererije;capitain der burgerij;capitain der burgerije;capn: der burgerij;captain of the civic guard;kapitein der burgerij
kapitein des armes	kapitain des armens;kapitain des arment;kapitain des armes;kapitain des arms
kapitein luitenant	capitain leuijtenant;capitain leytenant;capitain lieutenant;capitain lieutenant van de militie;capitain luijtenant;capitain luijtenant der militie;capitain luijtenant militair;capitain luitenant;capiteijn luijtenand;capitein lieutenant;capitein luijtenant der militair;capitein luijtenant der militia;capitein luijtenant der militie;kapitein-luitenant
kapitein-luitenant	capitain leuijtenant;capitain leytenant;capitain lieutenant;capitain lieutenant van de militie;capitain luijtenant;capitain luijtenant der militie;capitain luijtenant militair;capitain luitenant;capiteijn luijtenand;capitein lieutenant;capitein luijtenant der militair;capitein luijtenant der militia;capitein luijtenant der militie;kapitein luitenant
kapitijn	cap:;capetain;capetijn der militaijre;capitaijn;capitain;capitain commandant;capitain der militie;capitain miliair;capitain militair;capiteijn;capitein;capiteinn;capitijn;cappitain;capt:;captain;captain (military);captain der militie;captijn;kapitain
kasier	cassier;kassier
kassier	cassier;kasier
kastelein	herbergier;waard
kastenmaker	cabinet maker;meubelmaker;schrijnwerker
kattanar	cassanar;cassenairo;catenaar;cattenaar;cattenar
kladschilder	(house)painter;schilder
klerk	clercq;clerq;geswoore clerq van politie;geswore clerk van politie;gesworen clerq;klerq
klerq	clercq;clerq;geswoore clerq van politie;geswore clerk van politie;gesworen clerq;klerk
knife maker	messenmaker
kock	cook;koek
koek	cook;kock
kokmaet	cook's mate
kolonel-commandant	commander colonel
kommandant	command:;commandaent ;commandanr;commandant;commander ;commander of the soldiers;commandt:
kommandant der artillerie	hoofd van de artillerie
konstabelsmaat	constabelsmaet;constapelsmaat;constapelsmaet;weapons-master's mate
koopadministrateur	hoofd administrateur;hoofd-administrateur;hoofdadministrateur;secund;secunde;sekunde
koopm:	commies;coopman;merchant
koperslager	copper-smith
koporaal	coorporaal;copraal;corp:;corpaal;corparal;corperaal;corperal;corpolral;corpor:;corporaal;corporaar;corporael;corporal;corporâl;gegagieerden korporaal;korperaal;korporael
korenmeulenaar	korenmolenaar
korenmolenaar	korenmeulenaar
korperaal	coorporaal;copraal;corp:;corpaal;corparal;corperaal;corperal;corpolral;corpor:;corporaal;corporaar;corporael;corporal;corporâl;gegagieerden korporaal;koporaal;korporael
korporael	coorporaal;copraal;corp:;corpaal;corparal;corperaal;corperal;corpolral;corpor:;corporaal;corporaar;corporael;corporal;corporâl;gegagieerden korporaal;koporaal;korperaal
koster	coster;joster
krankbesoeker	infirmary visitor;krankbezoeker;lekelezer;ziekenbezoeker
krankbezoeker	infirmary visitor;krankbesoeker;lekelezer;ziekenbezoeker
kruijdmaaker	kruijdmaker;kruijdtmaeker;kruijmaker;kruijtmaker;kruitmaker
kruijdmaker	kruijdmaaker;kruijdtmaeker;kruijmaker;kruijtmaker;kruitmaker
kruijdtmaeker	kruijdmaaker;kruijdmaker;kruijmaker;kruijtmaker;kruitmaker
kruijmaker	kruijdmaaker;kruijdmaker;kruijdtmaeker;kruijtmaker;kruitmaker
kruijtmaker	kruijdmaaker;kruijdmaker;kruijdtmaeker;kruijmaker;kruitmaker
kruitmaker	kruijdmaaker;kruijdmaker;kruijdtmaeker;kruijmaker;kruijtmaker
kuijper	cooper;cuijper
kurup	goerip;guripo
laandheer	landheer;landsheer;lantheer
lance corporal	lance-corporal;lanspassaat
lance-corporal	lance corporal;lanspassaat
landheer	laandheer;landsheer;lantheer
landmeeter	landmeter;surveyor
landmeter	landmeeter;surveyor
landsheer	laandheer;landheer;lantheer
lanspassaat	lance corporal;lance-corporal
lantheer	laandheer;landheer;landsheer
lasc:	lascarijn;lascerijn;lascerrij;lascor;lascoreijn;lascorij;lascorijen;lascorijn;lascorijns;lascorin;lascorins;lasecrijn;lask:;laskaar;laskor;laskorijen;laskorijn;lscorijn;luscorijn
lascarijn	lasc:;lascerijn;lascerrij;lascor;lascoreijn;lascorij;lascorijen;lascorijn;lascorijns;lascorin;lascorins;lasecrijn;lask:;laskaar;laskor;laskorijen;laskorijn;lscorijn;luscorijn
lascerijn	lasc:;lascarijn;lascerrij;lascor;lascoreijn;lascorij;lascorijen;lascorijn;lascorijns;lascorin;lascorins;lasecrijn;lask:;laskaar;laskor;laskorijen;laskorijn;lscorijn;luscorijn
lascerrij	lasc:;lascarijn;lascerijn;lascor;lascoreijn;lascorij;lascorijen;lascorijn;lascorijns;lascorin;lascorins;lasecrijn;lask:;laskaar;laskor;laskorijen;laskorijn;lscorijn;luscorijn
lascor	lasc:;lascarijn;lascerijn;lascerrij;lascoreijn;lascorij;lascorijen;lascorijn;lascorijns;lascorin;lascorins;lasecrijn;lask:;laskaar;laskor;laskorijen;laskorijn;lscorijn;luscorijn
lascoreijn	lasc:;lascarijn;lascerijn;lascerrij;lascor;lascorij;lascorijen;lascorijn;lascorijns;lascorin;lascorins;lasecrijn;lask:;laskaar;laskor;laskorijen;laskorijn;lscorijn;luscorijn
lascorij	lasc:;lascarijn;lascerijn;lascerrij;lascor;lascoreijn;lascorijen;lascorijn;lascorijns;lascorin;lascorins;lasecrijn;lask:;laskaar;laskor;laskorijen;laskorijn;lscorijn;luscorijn
lascorijen	lasc:;lascarijn;lascerijn;lascerrij;lascor;lascoreijn;lascorij;lascorijn;lascorijns;lascorin;lascorins;lasecrijn;lask:;laskaar;laskor;laskorijen;laskorijn;lscorijn;luscorijn
lascorijn	lasc:;lascarijn;lascerijn;lascerrij;lascor;lascoreijn;lascorij;lascorijen;lascorijns;lascorin;lascorins;lasecrijn;lask:;laskaar;laskor;laskorijen;laskorijn;lscorijn;luscorijn
lascorijns	lasc:;lascarijn;lascerijn;lascerrij;lascor;lascoreijn;lascorij;lascorijen;lascorijn;lascorin;lascorins;lasecrijn;lask:;laskaar;laskor;laskorijen;laskorijn;lscorijn;luscorijn
lascorin	lasc:;lascarijn;lascerijn;lascerrij;lascor;lascoreijn;lascorij;lascorijen;lascorijn;lascorijns;lascorins;lasecrijn;lask:;laskaar;laskor;laskorijen;laskorijn;lscorijn;luscorijn
lascorins	lasc:;lascarijn;lascerijn;lascerrij;lascor;lascoreijn;lascorij;lascorijen;lascorijn;lascorijns;lascorin;lasecrijn;lask:;laskaar;laskor;laskorijen;laskorijn;lscorijn;luscorijn
lasecrijn	lasc:;lascarijn;lascerijn;lascerrij;lascor;lascoreijn;lascorij;lascorijen;lascorijn;lascorijns;lascorin;lascorins;lask:;laskaar;laskor;laskorijen;laskorijn;lscorijn;luscorijn
lask:	lasc:;lascarijn;lascerijn;lascerrij;lascor;lascoreijn;lascorij;lascorijen;lascorijn;lascorijns;lascorin;lascorins;lasecrijn;laskaar;laskor;laskorijen;laskorijn;lscorijn;luscorijn
laskaar	lasc:;lascarijn;lascerijn;lascerrij;lascor;lascoreijn;lascorij;lascorijen;lascorijn;lascorijns;lascorin;lascorins;lasecrijn;lask:;laskor;laskorijen;laskorijn;lscorijn;luscorijn
laskor	lasc:;lascarijn;lascerijn;lascerrij;lascor;lascoreijn;lascorij;lascorijen;lascorijn;lascorijns;lascorin;lascorins;lasecrijn;lask:;laskaar;laskorijen;laskorijn;lscorijn;luscorijn
laskorijen	lasc:;lascarijn;lascerijn;lascerrij;lascor;lascoreijn;lascorij;lascorijen;lascorijn;lascorijns;lascorin;lascorins;lasecrijn;lask:;laskaar;laskor;laskorijn;lscorijn;luscorijn
laskorijn	lasc:;lascarijn;lascerijn;lascerrij;lascor;lascoreijn;lascorij;lascorijen;lascorijn;lascorijns;lascorin;lascorins;lasecrijn;lask:;laskaar;laskor;laskorijen;lscorijn;luscorijn
leerberijder	leerlooier
leerlooier	leerberijder
leermeester	Inlands leermeester;docent;meester
leerthauwer	leerthouwer;leertouwer
leerthouwer	leerthauwer;leertouwer
leertouwer	leerthauwer;leerthouwer
lekelezer	infirmary visitor;krankbesoeker;krankbezoeker;ziekenbezoeker
leuijenant 	leuijtenant;lietenant;lieuten:;lieutenant;lieutenant der militie;lieutenant militair;lieutent:;lieutn:;liuijtenant;liuiten:;luijt;luijtenaent;luijtenand;luijtenant;luijtenant der militie;luijtenant militair;luijtent:;luitenant der oosterlingen;luitenant militair;luitnant ;luytenant;luytenant militair
leuijtenant	leuijenant ;lietenant;lieuten:;lieutenant;lieutenant der militie;lieutenant militair;lieutent:;lieutn:;liuijtenant;liuiten:;luijt;luijtenaent;luijtenand;luijtenant;luijtenant der militie;luijtenant militair;luijtent:;luitenant der oosterlingen;luitenant militair;luitnant ;luytenant;luytenant militair
lid van de Politieke Raad	Raad van Politie;lid van de Raad van Politie
lid van de Raad van Indië	Raad van Indië;Raad van Nederlandse India;extraordinaris raedt van india;raad extra ordinair van India 
lid van de Raad van Justitie	council of justice
lid van de Raad van Politie	Raad van Politie;lid van de Politieke Raad
lietenant	leuijenant ;leuijtenant;lieuten:;lieutenant;lieutenant der militie;lieutenant militair;lieutent:;lieutn:;liuijtenant;liuiten:;luijt;luijtenaent;luijtenand;luijtenant;luijtenant der militie;luijtenant militair;luijtent:;luitenant der oosterlingen;luitenant militair;luitnant ;luytenant;luytenant militair
lieuten:	leuijenant ;leuijtenant;lietenant;lieutenant;lieutenant der militie;lieutenant militair;lieutent:;lieutn:;liuijtenant;liuiten:;luijt;luijtenaent;luijtenand;luijtenant;luijtenant der militie;luijtenant militair;luijtent:;luitenant der oosterlingen;luitenant militair;luitnant ;luytenant;luytenant militair
lieutenant	leuijenant ;leuijtenant;lietenant;lieuten:;lieutenant der militie;lieutenant militair;lieutent:;lieutn:;liuijtenant;liuiten:;luijt;luijtenaent;luijtenand;luijtenant;luijtenant der militie;luijtenant militair;luijtent:;luitenant der oosterlingen;luitenant militair;luitnant ;luytenant;luytenant militair
lieutenant der arthillerie	Pl: kapitain luitenant der artillerije;lieutenant der arthillerije;luitenant van de artillerie;luitenant-ingenieur;sousluitenant der artillerie;sousluitenant der artillerij
lieutenant der arthillerije	Pl: kapitain luitenant der artillerije;lieutenant der arthillerie;luitenant van de artillerie;luitenant-ingenieur;sousluitenant der artillerie;sousluitenant der artillerij
lieutenant der militie	leuijenant ;leuijtenant;lietenant;lieuten:;lieutenant;lieutenant militair;lieutent:;lieutn:;liuijtenant;liuiten:;luijt;luijtenaent;luijtenand;luijtenant;luijtenant der militie;luijtenant militair;luijtent:;luitenant der oosterlingen;luitenant militair;luitnant ;luytenant;luytenant militair
lieutenant militair	leuijenant ;leuijtenant;lietenant;lieuten:;lieutenant;lieutenant der militie;lieutent:;lieutn:;liuijtenant;liuiten:;luijt;luijtenaent;luijtenand;luijtenant;luijtenant der militie;luijtenant militair;luijtent:;luitenant der oosterlingen;luitenant militair;luitnant ;luytenant;luytenant militair
lieutent:	leuijenant ;leuijtenant;lietenant;lieuten:;lieutenant;lieutenant der militie;lieutenant militair;lieutn:;liuijtenant;liuiten:;luijt;luijtenaent;luijtenand;luijtenant;luijtenant der militie;luijtenant militair;luijtent:;luitenant der oosterlingen;luitenant militair;luitnant ;luytenant;luytenant militair
lieutn:	leuijenant ;leuijtenant;lietenant;lieuten:;lieutenant;lieutenant der militie;lieutenant militair;lieutent:;liuijtenant;liuiten:;luijt;luijtenaent;luijtenand;luijtenant;luijtenant der militie;luijtenant militair;luijtent:;luitenant der oosterlingen;luitenant militair;luitnant ;luytenant;luytenant militair
lijndraaier	lijndraijer ;rope-maker
lijndraijer 	lijndraaier;rope-maker
liuijtenant	leuijenant ;leuijtenant;lietenant;lieuten:;lieutenant;lieutenant der militie;lieutenant militair;lieutent:;lieutn:;liuiten:;luijt;luijtenaent;luijtenand;luijtenant;luijtenant der militie;luijtenant militair;luijtent:;luitenant der oosterlingen;luitenant militair;luitnant ;luytenant;luytenant militair
liuiten:	leuijenant ;leuijtenant;lietenant;lieuten:;lieutenant;lieutenant der militie;lieutenant militair;lieutent:;lieutn:;liuijtenant;luijt;luijtenaent;luijtenand;luijtenant;luijtenant der militie;luijtenant militair;luijtent:;luitenant der oosterlingen;luitenant militair;luitnant ;luytenant;luytenant militair
lock maker	lockmaker;slootemaker;slotenmaker
lockmaker	lock maker;slootemaker;slotenmaker
loog bootsm:	boatswain;boodsmaen;boodsman;boosman;boostman;bootsman;first boatswain;gegagieerd bootsman;hoog bootsman;hoogbootsman;oogbootsman
lscorijn	lasc:;lascarijn;lascerijn;lascerrij;lascor;lascoreijn;lascorij;lascorijen;lascorijn;lascorijns;lascorin;lascorins;lasecrijn;lask:;laskaar;laskor;laskorijen;laskorijn;luscorijn
luijt	leuijenant ;leuijtenant;lietenant;lieuten:;lieutenant;lieutenant der militie;lieutenant militair;lieutent:;lieutn:;liuijtenant;liuiten:;luijtenaent;luijtenand;luijtenant;luijtenant der militie;luijtenant militair;luijtent:;luitenant der oosterlingen;luitenant militair;luitnant ;luytenant;luytenant militair
luijtenaent	leuijenant ;leuijtenant;lietenant;lieuten:;lieutenant;lieutenant der militie;lieutenant militair;lieutent:;lieutn:;liuijtenant;liuiten:;luijt;luijtenand;luijtenant;luijtenant der militie;luijtenant militair;luijtent:;luitenant der oosterlingen;luitenant militair;luitnant ;luytenant;luytenant militair
luijtenand	leuijenant ;leuijtenant;lietenant;lieuten:;lieutenant;lieutenant der militie;lieutenant militair;lieutent:;lieutn:;liuijtenant;liuiten:;luijt;luijtenaent;luijtenant;luijtenant der militie;luijtenant militair;luijtent:;luitenant der oosterlingen;luitenant militair;luitnant ;luytenant;luytenant militair
luijtenant	leuijenant ;leuijtenant;lietenant;lieuten:;lieutenant;lieutenant der militie;lieutenant militair;lieutent:;lieutn:;liuijtenant;liuiten:;luijt;luijtenaent;luijtenand;luijtenant der militie;luijtenant militair;luijtent:;luitenant der oosterlingen;luitenant militair;luitnant ;luytenant;luytenant militair
luijtenant commandant	luijtent: commandant;luitenant-commandant
luijtenant der militie	leuijenant ;leuijtenant;lietenant;lieuten:;lieutenant;lieutenant der militie;lieutenant militair;lieutent:;lieutn:;liuijtenant;liuiten:;luijt;luijtenaent;luijtenand;luijtenant;luijtenant militair;luijtent:;luitenant der oosterlingen;luitenant militair;luitnant ;luytenant;luytenant militair
luijtenant militair	leuijenant ;leuijtenant;lietenant;lieuten:;lieutenant;lieutenant der militie;lieutenant militair;lieutent:;lieutn:;liuijtenant;liuiten:;luijt;luijtenaent;luijtenand;luijtenant;luijtenant der militie;luijtent:;luitenant der oosterlingen;luitenant militair;luitnant ;luytenant;luytenant militair
luijtent:	leuijenant ;leuijtenant;lietenant;lieuten:;lieutenant;lieutenant der militie;lieutenant militair;lieutent:;lieutn:;liuijtenant;liuiten:;luijt;luijtenaent;luijtenand;luijtenant;luijtenant der militie;luijtenant militair;luitenant der oosterlingen;luitenant militair;luitnant ;luytenant;luytenant militair
luijtent: commandant	luijtenant commandant;luitenant-commandant
luitenant (zeeman)	eerste stuurman;first mate;opperstuurman
luitenant der burgerij	luitenant van de burgerij
luitenant der oosterlingen	leuijenant ;leuijtenant;lietenant;lieuten:;lieutenant;lieutenant der militie;lieutenant militair;lieutent:;lieutn:;liuijtenant;liuiten:;luijt;luijtenaent;luijtenand;luijtenant;luijtenant der militie;luijtenant militair;luijtent:;luitenant militair;luitnant ;luytenant;luytenant militair
luitenant militair	leuijenant ;leuijtenant;lietenant;lieuten:;lieutenant;lieutenant der militie;lieutenant militair;lieutent:;lieutn:;liuijtenant;liuiten:;luijt;luijtenaent;luijtenand;luijtenant;luijtenant der militie;luijtenant militair;luijtent:;luitenant der oosterlingen;luitnant ;luytenant;luytenant militair
luitenant van de artillerie	Pl: kapitain luitenant der artillerije;lieutenant der arthillerie;lieutenant der arthillerije;luitenant-ingenieur;sousluitenant der artillerie;sousluitenant der artillerij
luitenant van de burgerij	luitenant der burgerij
luitenant-commandant	luijtenant commandant;luijtent: commandant
luitenant-ingenieur	Pl: kapitain luitenant der artillerije;lieutenant der arthillerie;lieutenant der arthillerije;luitenant van de artillerie;sousluitenant der artillerie;sousluitenant der artillerij
luitnant 	leuijenant ;leuijtenant;lietenant;lieuten:;lieutenant;lieutenant der militie;lieutenant militair;lieutent:;lieutn:;liuijtenant;liuiten:;luijt;luijtenaent;luijtenand;luijtenant;luijtenant der militie;luijtenant militair;luijtent:;luitenant der oosterlingen;luitenant militair;luytenant;luytenant militair
luscorijn	lasc:;lascarijn;lascerijn;lascerrij;lascor;lascoreijn;lascorij;lascorijen;lascorijn;lascorijns;lascorin;lascorins;lasecrijn;lask:;laskaar;laskor;laskorijen;laskorijn;lscorijn
luytenant	leuijenant ;leuijtenant;lietenant;lieuten:;lieutenant;lieutenant der militie;lieutenant militair;lieutent:;lieutn:;liuijtenant;liuiten:;luijt;luijtenaent;luijtenand;luijtenant;luijtenant der militie;luijtenant militair;luijtent:;luitenant der oosterlingen;luitenant militair;luitnant ;luytenant militair
luytenant militair	leuijenant ;leuijtenant;lietenant;lieuten:;lieutenant;lieutenant der militie;lieutenant militair;lieutent:;lieutn:;liuijtenant;liuiten:;luijt;luijtenaent;luijtenand;luijtenant;luijtenant der militie;luijtenant militair;luijtent:;luitenant der oosterlingen;luitenant militair;luitnant ;luytenant
maetroos	matoos;mattroos;sailor
mandadoor	mandur;supervisor of Asian crew members
mandur	mandadoor;supervisor of Asian crew members
manual fire engine maker	brandspuitmaker;brandspuitslangenmaker;fire hose maker
map maker	cartemaker;kaartmaker;mapmaker
mapmaker	cartemaker;kaartmaker;map maker
master-at-arms	provoost
matoos	maetroos;mattroos;sailor
mattroos	maetroos;matoos;sailor
meester	Inlands leermeester;chirugijn;chirurgeijn;chrirugijn;churugeijn;chururgijn;docent;leermeester;sirurgeijn;surgeon
meester knegt den smitswinkel	meester knegt der smits;meester knegt der smitswinkel;meesterknecht der smidswinkel;meesterknegt den smits winkel;meesterknegt den smitswinkel;meesterknegt der smits winkel;meesterknegt der smitswinkel;meesterknegt smits winkel;meesterknegt smitswinkel;misterknigt der smids wenken
meester knegt der schipstimmerwerf	meesterknecht der scheepstimmerwerf;meesterknegt der scheepstimmerwerf
meester knegt der smits	meester knegt den smitswinkel;meester knegt der smitswinkel;meesterknecht der smidswinkel;meesterknegt den smits winkel;meesterknegt den smitswinkel;meesterknegt der smits winkel;meesterknegt der smitswinkel;meesterknegt smits winkel;meesterknegt smitswinkel;misterknigt der smids wenken
meester knegt der smitswinkel	meester knegt den smitswinkel;meester knegt der smits;meesterknecht der smidswinkel;meesterknegt den smits winkel;meesterknegt den smitswinkel;meesterknegt der smits winkel;meesterknegt der smitswinkel;meesterknegt smits winkel;meesterknegt smitswinkel;misterknigt der smids wenken
meesterknecht der scheepstimmerwerf	meester knegt der schipstimmerwerf;meesterknegt der scheepstimmerwerf
meesterknecht der smidswinkel	meester knegt den smitswinkel;meester knegt der smits;meester knegt der smitswinkel;meesterknegt den smits winkel;meesterknegt den smitswinkel;meesterknegt der smits winkel;meesterknegt der smitswinkel;meesterknegt smits winkel;meesterknegt smitswinkel;misterknigt der smids wenken
meesterknecht der wapenkamer	meesterknegt der wapenkamer
meesterknegt den smits winkel	meester knegt den smitswinkel;meester knegt der smits;meester knegt der smitswinkel;meesterknecht der smidswinkel;meesterknegt den smitswinkel;meesterknegt der smits winkel;meesterknegt der smitswinkel;meesterknegt smits winkel;meesterknegt smitswinkel;misterknigt der smids wenken
meesterknegt den smitswinkel	meester knegt den smitswinkel;meester knegt der smits;meester knegt der smitswinkel;meesterknecht der smidswinkel;meesterknegt den smits winkel;meesterknegt der smits winkel;meesterknegt der smitswinkel;meesterknegt smits winkel;meesterknegt smitswinkel;misterknigt der smids wenken
meesterknegt der scheepstimmerwerf	meester knegt der schipstimmerwerf;meesterknecht der scheepstimmerwerf
meesterknegt der smits winkel	meester knegt den smitswinkel;meester knegt der smits;meester knegt der smitswinkel;meesterknecht der smidswinkel;meesterknegt den smits winkel;meesterknegt den smitswinkel;meesterknegt der smitswinkel;meesterknegt smits winkel;meesterknegt smitswinkel;misterknigt der smids wenken
meesterknegt der smitswinkel	meester knegt den smitswinkel;meester knegt der smits;meester knegt der smitswinkel;meesterknecht der smidswinkel;meesterknegt den smits winkel;meesterknegt den smitswinkel;meesterknegt der smits winkel;meesterknegt smits winkel;meesterknegt smitswinkel;misterknigt der smids wenken
meesterknegt der wapenkamer	meesterknecht der wapenkamer
meesterknegt smits winkel	meester knegt den smitswinkel;meester knegt der smits;meester knegt der smitswinkel;meesterknecht der smidswinkel;meesterknegt den smits winkel;meesterknegt den smitswinkel;meesterknegt der smits winkel;meesterknegt der smitswinkel;meesterknegt smitswinkel;misterknigt der smids wenken
meesterknegt smitswinkel	meester knegt den smitswinkel;meester knegt der smits;meester knegt der smitswinkel;meesterknecht der smidswinkel;meesterknegt den smits winkel;meesterknegt den smitswinkel;meesterknegt der smits winkel;meesterknegt der smitswinkel;meesterknegt smits winkel;misterknigt der smids wenken
merchant	commies;coopman;koopm:
merchant's assistant	absolut assistent;absoluut assistent;adsistend;adsistendt;adsistent;adssistent;adssitend;asdsistent;asiestend;asistent;assistant;assistant to the (chief) merchant;assistend;assistendt;assistent;schrijver
messenmaker	knife maker
metselaer	bricklayer;gegagieerden metselaar
meubelmaker	cabinet maker;kastenmaker;schrijnwerker
midshipman	adelborts;aldelborst
midwife	verloskundige
miller	molenaer
minister	bedienaar der goddelijken woord;bedienaar der goddelijken woords;bedienaar des goddelijken woords;bedienaar des goddelijken woorts;bedienaar des godelijker woords;bedienaar des godelijkse woords;bedinaar des goddelijken woords;bedinaar des goddelijken woorts;bedinaar des goddelijks woorts;dominee;predicant;predikant
misterknigt der smids wenken	meester knegt den smitswinkel;meester knegt der smits;meester knegt der smitswinkel;meesterknecht der smidswinkel;meesterknegt den smits winkel;meesterknegt den smitswinkel;meesterknegt der smits winkel;meesterknegt der smitswinkel;meesterknegt smits winkel;meesterknegt smitswinkel
mocquadon	mocquodon;mocuddum
mocquodon	mocquadon;mocuddum
mocuddum	mocquadon;mocquodon
molenaer	miller
molenmaker	windmill maker
musician	Muzikanten
nachoda	an-nakhoda;anachoda;annakhoda;nakhuda
nakhuda	an-nakhoda;anachoda;annakhoda;nachoda
navigator	steersman;stuurman
offecier	Militaire officieren;officer;officier
officer	Militaire officieren;offecier;officier
officer responsible for provisioning of soldiers	fourier;quartermaster
officier	Militaire officieren;offecier;officer
onder chirurgijn	onder surigijn;onderchirurgijn;onderchururgijn;ondermeester;second medical master (orig.: ondermeester);second surgeon;second surgeon (orig.: onderchirurgijn)
onder leuijtenant	onder lieutenant ;onderluijtenant ;onderluitenant;second lieutenant (military) ;sousluitenant
onder lieutenant 	onder leuijtenant;onderluijtenant ;onderluitenant;second lieutenant (military) ;sousluitenant
onder mandadoor	second supervisor of Asian crew members
onder surigijn	onder chirurgijn;onderchirurgijn;onderchururgijn;ondermeester;second medical master (orig.: ondermeester);second surgeon;second surgeon (orig.: onderchirurgijn)
onder(scheeps)timmerman	onderscheepstimmerman;ship-carpenter's mate
onderadjudant	adjudant;adjundant
onderbarbier	assistant barber-surgeon;second barber
onderchirurgijn	onder chirurgijn;onder surigijn;onderchururgijn;ondermeester;second medical master (orig.: ondermeester);second surgeon;second surgeon (orig.: onderchirurgijn)
onderchururgijn	onder chirurgijn;onder surigijn;onderchirurgijn;ondermeester;second medical master (orig.: ondermeester);second surgeon;second surgeon (orig.: onderchirurgijn)
ondercoop:	junior merchant;ondercoopan;ondercoopman;onderkoomman;onderkoopman;onderokoopman
ondercoopan	junior merchant;ondercoop:;ondercoopman;onderkoomman;onderkoopman;onderokoopman
ondercoopman	junior merchant;ondercoop:;ondercoopan;onderkoomman;onderkoopman;onderokoopman
onderkanonnier	second cannoneer;second gunner
onderkoomman	junior merchant;ondercoop:;ondercoopan;ondercoopman;onderkoopman;onderokoopman
onderkoopman	junior merchant;ondercoop:;ondercoopan;ondercoopman;onderkoomman;onderokoopman
onderkruijtmaker	onderkruitmaker
onderkruitmaker	onderkruijtmaker
onderkuijper	onderkuiper
onderkuiper	onderkuijper
onderluijtenant 	onder leuijtenant;onder lieutenant ;onderluitenant;second lieutenant (military) ;sousluitenant
onderluitenant	onder leuijtenant;onder lieutenant ;onderluijtenant ;second lieutenant (military) ;sousluitenant
ondermajoor	Onder-major
ondermeester	onder chirurgijn;onder surigijn;onderchirurgijn;onderchururgijn;second medical master (orig.: ondermeester);second surgeon;second surgeon (orig.: onderchirurgijn)
onderokoopman	junior merchant;ondercoop:;ondercoopan;ondercoopman;onderkoomman;onderkoopman
onderscheepstimmerman	onder(scheeps)timmerman;ship-carpenter's mate
ondersergeant	second sergeant
onderstuurman	second mate;tweede stuurman
onderwatermaker	Onder-watermaker;Water-maker's mate
onderzeilmaker	second sail-maker's mate
oogbootsman	boatswain;boodsmaen;boodsman;boosman;boostman;bootsman;first boatswain;gegagieerd bootsman;hoog bootsman;hoogbootsman;loog bootsm:
operchirurgijn	Opermeester van 's komps: Hospitaal;opermeester;oppercheriorgijn;opperchigeirgijn;opperchirugijn;opperchirurgeijn;opperchirurgijn;oppermeester;senior medical master;senior surgeon
opermeester	Opermeester van 's komps: Hospitaal;operchirurgijn;oppercheriorgijn;opperchigeirgijn;opperchirugijn;opperchirurgeijn;opperchirurgijn;oppermeester;senior medical master;senior surgeon
oploper	hoogloper;hooplooper;jong matroos;jongmatroos;junior sailor;juniormatroos
opper koopman	chief merchant;oppercoopman;senior merchant
opperceijlmaaker	chief sailmaker;opperseijlmaker;opperzeilmaker;senior sail maker
oppercheriorgijn	Opermeester van 's komps: Hospitaal;operchirurgijn;opermeester;opperchigeirgijn;opperchirugijn;opperchirurgeijn;opperchirurgijn;oppermeester;senior medical master;senior surgeon
opperchigeirgijn	Opermeester van 's komps: Hospitaal;operchirurgijn;opermeester;oppercheriorgijn;opperchirugijn;opperchirurgeijn;opperchirurgijn;oppermeester;senior medical master;senior surgeon
opperchirugijn	Opermeester van 's komps: Hospitaal;operchirurgijn;opermeester;oppercheriorgijn;opperchigeirgijn;opperchirurgeijn;opperchirurgijn;oppermeester;senior medical master;senior surgeon
opperchirurgeijn	Opermeester van 's komps: Hospitaal;operchirurgijn;opermeester;oppercheriorgijn;opperchigeirgijn;opperchirugijn;opperchirurgijn;oppermeester;senior medical master;senior surgeon
opperchirurgijn	Opermeester van 's komps: Hospitaal;operchirurgijn;opermeester;oppercheriorgijn;opperchigeirgijn;opperchirugijn;opperchirurgeijn;oppermeester;senior medical master;senior surgeon
oppercoopman	chief merchant;opper koopman;senior merchant
opperhoofd	opperhooft
opperhooft	opperhoofd
opperkonstabel	senior weapons master
opperkuijper	baas der kuipers;first cooper;opperkuiper
opperkuiper	baas der kuipers;first cooper;opperkuijper
oppermandoor	first supervisor of Asian crew members;oppermandor
oppermandor	first supervisor of Asian crew members;oppermandoor
oppermeester	Opermeester van 's komps: Hospitaal;operchirurgijn;opermeester;oppercheriorgijn;opperchigeirgijn;opperchirugijn;opperchirurgeijn;opperchirurgijn;senior medical master;senior surgeon
opperscheepstimmerman	Baas Scheeps Timmerm;baas der scheepstimmerlieden;baas der scheepstimmermannen;baas der scheepstimmerwerf;baas der scheeptimmerlieden;baas der schipstimmerwerf;senior ship carpenter
opperschieman	senior boatswain
opperseijlmaker	chief sailmaker;opperceijlmaaker;opperzeilmaker;senior sail maker
opperstuurman	eerste stuurman;first mate;luitenant (zeeman)
oppertemmerman	baas der timmermannen;oppertimmerman
oppertimmerman	baas der timmermannen;oppertemmerman
opperwatermaker	senior water maker
opperzeilmaker	chief sailmaker;opperceijlmaaker;opperseijlmaker;senior sail maker
opsiender	Opsiender der houtthuin;Opsiender der scheeps timmerwerff;Opsiender der scheepstimmerwerf;Opsiender der wapencamer;Opziender van de Smitswinkel;opsiender der houtthuijn;opziender;opziener
opsiender der houtthuijn	Opsiender der houtthuin;Opsiender der scheeps timmerwerff;Opsiender der scheepstimmerwerf;Opsiender der wapencamer;Opziender van de Smitswinkel;opsiender;opziender;opziener
opziender	Opsiender der houtthuin;Opsiender der scheeps timmerwerff;Opsiender der scheepstimmerwerf;Opsiender der wapencamer;Opziender van de Smitswinkel;opsiender;opsiender der houtthuijn;opziener
opziener	Opsiender der houtthuin;Opsiender der scheeps timmerwerff;Opsiender der scheepstimmerwerf;Opsiender der wapencamer;Opziender van de Smitswinkel;opsiender;opsiender der houtthuijn;opziender
orderserjant	gegagieerd sergeant;segeant;sergeant;sergiaant;sergiaent;sergiand;sergiant;serginat;sergt:;serishant;serjant;zergeant;zergiand;zergiant;zergt:
paater	Francisca pater;Franciscand pater;pater
pachter	belastingpachter;pagter
packhuijsmeester	pakhuijsmeester;pakhuismeester
pagter	belastingpachter;pachter
pakhuijsmeester	packhuijsmeester;pakhuismeester
pakhuismeester	packhuijsmeester;pakhuijsmeester
panical	paniken;panikkar
paniken	panical;panikkar
panikkar	panical;paniken
pannebakker	baas der pannebakkers;baas der pannenbakkers;pannenbakker
pannenbakker	pannebakker
pater	Francisca pater;Franciscand pater;paater
peijper	fluiter;piper
penist	penneest;penniset;pennish;pennist;pinnest
penneest	penist;penniset;pennish;pennist;pinnest
penniset	penist;penneest;pennish;pennist;pinnest
pennish	penist;penneest;penniset;pennist;pinnest
pennist	penist;penneest;penniset;pennish;pinnest
pinnest	penist;penneest;penniset;pennish;pennist
piper	fluiter;peijper
politique bedienden	Administration and government
posth:	posthou;posthoud;posthouder;posthouderen;posthouderer;psthouder
posthou	posth:;posthoud;posthouder;posthouderen;posthouderer;psthouder
posthoud	posth:;posthou;posthouder;posthouderen;posthouderer;psthouder
posthouder	posth:;posthou;posthoud;posthouderen;posthouderer;psthouder
posthouderen	posth:;posthou;posthoud;posthouder;posthouderer;psthouder
posthouderer	posth:;posthou;posthoud;posthouder;posthouderen;psthouder
predicant	bedienaar der goddelijken woord;bedienaar der goddelijken woords;bedienaar des goddelijken woords;bedienaar des goddelijken woorts;bedienaar des godelijker woords;bedienaar des godelijkse woords;bedinaar des goddelijken woords;bedinaar des goddelijken woorts;bedinaar des goddelijks woorts;dominee;minister;predikant
predikant	bedienaar der goddelijken woord;bedienaar der goddelijken woords;bedienaar des goddelijken woords;bedienaar des goddelijken woorts;bedienaar des godelijker woords;bedienaar des godelijkse woords;bedinaar des goddelijken woords;bedinaar des goddelijken woorts;bedinaar des goddelijks woorts;dominee;minister;predicant
premier luitenant	eerste luitenant
prosecutor	fiscaal;fiscael;fiskaal
provoost	master-at-arms
provoost geweldige	geweldige;geweldige provoost;geweldiger;gewelliger
psthouder	posth:;posthou;posthoud;posthouder;posthouderen;posthouderer
quaertiermeester	quartermaster;quartierm:;quartiermeester
quarnisoenschrijver	garnisoenschrijver;garnizoenschrijver;guarnesoen schrijver;guarni soen schrijver;guarniesoen schrijver;guarnisoen schrijver;guarnisoenschrijver;guarrisoen schrijver
quartermaster	fourier;officer responsible for provisioning of soldiers;quaertiermeester;quartierm:;quartiermeester
quartierm:	quaertiermeester;quartermaster;quartiermeester
quartiermeester	quaertiermeester;quartermaster;quartierm:
raad extra ordinair van India 	Raad van Indië;Raad van Nederlandse India;extraordinaris raedt van india;lid van de Raad van Indië
rademaker	wheel maker
reisdent	resdt:;residen;residend;resident;resiedent;ressitend;rezident
resdt:	reisdent;residen;residend;resident;resiedent;ressitend;rezident
residen	reisdent;resdt:;residend;resident;resiedent;ressitend;rezident
residend	reisdent;resdt:;residen;resident;resiedent;ressitend;rezident
resident	reisdent;resdt:;residen;residend;resiedent;ressitend;rezident
resiedent	reisdent;resdt:;residen;residend;resident;ressitend;rezident
ressitend	reisdent;resdt:;residen;residend;resident;resiedent;rezident
rezident	reisdent;resdt:;residen;residend;resident;resiedent;ressitend
ritmeester	cavalry captain
roerslotenmaker	slotenmaker
rope-maker	lijndraaier;lijndraijer 
sabandaar	shabandaar;sjabandaar;sjahbandar
sadelmaaker	sadelmaeker;sadelmaker;zadelmaaker;zadelmaker
sadelmaeker	sadelmaaker;sadelmaker;zadelmaaker;zadelmaker
sadelmaker	sadelmaaker;sadelmaeker;zadelmaaker;zadelmaker
sail maker	seijlmaker;sseijlmaker;zeijlmaker;zeilmaker;zeylemaker;zijlemaker
sailor	maetroos;matoos;mattroos
sarang	sarangie;serang
sarangie	sarang;serang
sarbadikariakaar	Sarawadi;Sarawadij;Sarwadi;Sarwadi Karyakkaran
schedemaker	scheedemaker
scheedemaker	schedemaker
scheeps timmerman	scheeptimmerman;schipstimmerman;ship carpenter;ship's carpenter
scheepscorporaal	scheepskorporaal;ship corporal
scheepskorporaal	scheepscorporaal;ship corporal
scheeptimmerman	scheeps timmerman;schipstimmerman;ship carpenter;ship's carpenter
scherprechter	beul;scherpregter
scherpregter	beul;scherprechter
schieman	boatswain (foremast);schiemand;tweede bootsman
schiemand	boatswain (foremast);schieman;tweede bootsman
schiemansmaat	boatswain's mate (foremast);schiemansmaet;schimansmaat;tweede schieman
schiemansmaet	boatswain's mate (foremast);schiemansmaat;schimansmaat;tweede schieman
schilder	(house)painter;kladschilder
schimansmaat	boatswain's mate (foremast);schiemansmaat;schiemansmaet;tweede schieman
schipheer	gezagvoerder;schipper
schipper	gezagvoerder;schipheer
schipstimmerman	scheeps timmerman;scheeptimmerman;ship carpenter;ship's carpenter
schriba	schribent;scriba;scribent
schribent	schriba;scriba;scribent
schrijnwerker	cabinet maker;kastenmaker;meubelmaker
schrijver	absolut assistent;absoluut assistent;adsistend;adsistendt;adsistent;adssistent;adssitend;asdsistent;asiestend;asistent;assistant;assistant to the (chief) merchant;assistend;assistendt;assistent;merchant's assistant
scriba	schriba;schribent;scribent
scribent	schriba;schribent;scriba
seaman	bootsgesel;chinese seaman
second barber	assistant barber-surgeon;onderbarbier
second barber-surgeon	tweede barbier
second cannoneer	onderkanonnier;second gunner
second gunner	onderkanonnier;second cannoneer
second lance-corporal	tweede lanspassaat
second lieutenant (military)	tweede luitenant
second lieutenant (military) 	onder leuijtenant;onder lieutenant ;onderluijtenant ;onderluitenant;sousluitenant
second mate	onderstuurman;tweede stuurman
second medical master (orig.: ondermeester)	onder chirurgijn;onder surigijn;onderchirurgijn;onderchururgijn;ondermeester;second surgeon;second surgeon (orig.: onderchirurgijn)
second sail maker	tweede zeilmaker
second sail-maker's mate	onderzeilmaker
second sergeant	ondersergeant
second supervisor of Asian crew members	onder mandadoor
second surgeon	onder chirurgijn;onder surigijn;onderchirurgijn;onderchururgijn;ondermeester;second medical master (orig.: ondermeester);second surgeon (orig.: onderchirurgijn);tweede meester
second surgeon (orig.: onderchirurgijn)	onder chirurgijn;onder surigijn;onderchirurgijn;onderchururgijn;ondermeester;second medical master (orig.: ondermeester);second surgeon
second-surgeon's mate	tweede onderchirurgijn
secretaris	secrets:
secrets:	secretaris
secund	hoofd administrateur;hoofd-administrateur;hoofdadministrateur;koopadministrateur;secunde;sekunde
secunde	hoofd administrateur;hoofd-administrateur;hoofdadministrateur;koopadministrateur;secund;sekunde
segeant	gegagieerd sergeant;orderserjant;sergeant;sergiaant;sergiaent;sergiand;sergiant;serginat;sergt:;serishant;serjant;zergeant;zergiand;zergiant;zergt:
seijlmaker	sail maker;sseijlmaker;zeijlmaker;zeilmaker;zeylemaker;zijlemaker
sekunde	hoofd administrateur;hoofd-administrateur;hoofdadministrateur;koopadministrateur;secund;secunde
senior barber-surgeon	senior barbier
senior barbier	senior barber-surgeon
senior boatswain	opperschieman
senior medical master	Opermeester van 's komps: Hospitaal;operchirurgijn;opermeester;oppercheriorgijn;opperchigeirgijn;opperchirugijn;opperchirurgeijn;opperchirurgijn;oppermeester;senior surgeon
senior merchant	chief merchant;opper koopman;oppercoopman
senior sail maker	chief sailmaker;opperceijlmaaker;opperseijlmaker;opperzeilmaker
senior ship carpenter	Baas Scheeps Timmerm;baas der scheepstimmerlieden;baas der scheepstimmermannen;baas der scheepstimmerwerf;baas der scheeptimmerlieden;baas der schipstimmerwerf;opperscheepstimmerman
senior surgeon	Opermeester van 's komps: Hospitaal;operchirurgijn;opermeester;oppercheriorgijn;opperchigeirgijn;opperchirugijn;opperchirurgeijn;opperchirurgijn;oppermeester;senior medical master
senior water maker	opperwatermaker
senior weapons master	opperkonstabel
sepai	siapij;sipahi;sipai;sipaij;sipair;sipais;siphahis;siphai;siphaij;sippaijs
serang	sarang;sarangie
sergant der blanke burgerij	sergeant der blanke burgerije;sergeant van de burgerij;sergiant der blanke burgerije
sergeant	gegagieerd sergeant;orderserjant;segeant;sergiaant;sergiaent;sergiand;sergiant;serginat;sergt:;serishant;serjant;zergeant;zergiand;zergiant;zergt:
sergeant der blanke burgerije	sergant der blanke burgerij;sergeant van de burgerij;sergiant der blanke burgerije
sergeant majoor	sergeant-majoor
sergeant van de burgerij	sergant der blanke burgerij;sergeant der blanke burgerije;sergiant der blanke burgerije
sergeant-majoor	sergeant majoor
sergiaant	gegagieerd sergeant;orderserjant;segeant;sergeant;sergiaent;sergiand;sergiant;serginat;sergt:;serishant;serjant;zergeant;zergiand;zergiant;zergt:
sergiaent	gegagieerd sergeant;orderserjant;segeant;sergeant;sergiaant;sergiand;sergiant;serginat;sergt:;serishant;serjant;zergeant;zergiand;zergiant;zergt:
sergiand	gegagieerd sergeant;orderserjant;segeant;sergeant;sergiaant;sergiaent;sergiant;serginat;sergt:;serishant;serjant;zergeant;zergiand;zergiant;zergt:
sergiant	gegagieerd sergeant;orderserjant;segeant;sergeant;sergiaant;sergiaent;sergiand;serginat;sergt:;serishant;serjant;zergeant;zergiand;zergiant;zergt:
sergiant der blanke burgerije	sergant der blanke burgerij;sergeant der blanke burgerije;sergeant van de burgerij
serginat	gegagieerd sergeant;orderserjant;segeant;sergeant;sergiaant;sergiaent;sergiand;sergiant;sergt:;serishant;serjant;zergeant;zergiand;zergiant;zergt:
sergt:	gegagieerd sergeant;orderserjant;segeant;sergeant;sergiaant;sergiaent;sergiand;sergiant;serginat;serishant;serjant;zergeant;zergiand;zergiant;zergt:
serishant	gegagieerd sergeant;orderserjant;segeant;sergeant;sergiaant;sergiaent;sergiand;sergiant;serginat;sergt:;serjant;zergeant;zergiand;zergiant;zergt:
serjant	gegagieerd sergeant;orderserjant;segeant;sergeant;sergiaant;sergiaent;sergiand;sergiant;serginat;sergt:;serishant;zergeant;zergiand;zergiant;zergt:
shabandaar	sabandaar;sjabandaar;sjahbandar
ship carpenter	scheeps timmerman;scheeptimmerman;schipstimmerman;ship's carpenter
ship corporal	scheepscorporaal;scheepskorporaal
ship's boy	cabin boy;jongen
ship's carpenter	scheeps timmerman;scheeptimmerman;schipstimmerman;ship carpenter
ship-carpenter's mate	onder(scheeps)timmerman;onderscheepstimmerman
siapij	sepai;sipahi;sipai;sipaij;sipair;sipais;siphahis;siphai;siphaij;sippaijs
siekentroost	sieketrooster;spiritual comforter;ziekentroost;ziekentrooster
sieketrooster	siekentroost;spiritual comforter;ziekentroost;ziekentrooster
siepier	cepier;ciepier;cipier;sipier
silversmid	zilversmid;zilversmith
sipahi	sepai;siapij;sipai;sipaij;sipair;sipais;siphahis;siphai;siphaij;sippaijs
sipai	sepai;siapij;sipahi;sipaij;sipair;sipais;siphahis;siphai;siphaij;sippaijs
sipaij	sepai;siapij;sipahi;sipai;sipair;sipais;siphahis;siphai;siphaij;sippaijs
sipair	sepai;siapij;sipahi;sipai;sipaij;sipais;siphahis;siphai;siphaij;sippaijs
sipais	sepai;siapij;sipahi;sipai;sipaij;sipair;siphahis;siphai;siphaij;sippaijs
siphahis	sepai;siapij;sipahi;sipai;sipaij;sipair;sipais;siphai;siphaij;sippaijs
siphai	sepai;siapij;sipahi;sipai;sipaij;sipair;sipais;siphahis;siphaij;sippaijs
siphaij	sepai;siapij;sipahi;sipai;sipaij;sipair;sipais;siphahis;siphai;sippaijs
sipier	cepier;ciepier;cipier;siepier
sippaijs	sepai;siapij;sipahi;sipai;sipaij;sipair;sipais;siphahis;siphai;siphaij
sirurgeijn	chirugijn;chirurgeijn;chrirugijn;churugeijn;chururgijn;meester;surgeon
sjabandaar	sabandaar;shabandaar;sjahbandar
sjahbandar	sabandaar;shabandaar;sjabandaar
slootemaker	lock maker;lockmaker;slotenmaker
slotenmaker	lock maker;lockmaker;roerslotenmaker;slootemaker
smidsgezel	smitsgesel
smit	smith;smits
smith	smit;smits
smits	smit;smith
smitsgesel	smidsgezel
soldaaat	gegagieerde soldaat;gemene;soldaar;soldaet;soldat;soldier;solt:;zoldaat;zoldaet;zoldt:
soldaar	gegagieerde soldaat;gemene;soldaaat;soldaet;soldat;soldier;solt:;zoldaat;zoldaet;zoldt:
soldaet	gegagieerde soldaat;gemene;soldaaat;soldaar;soldat;soldier;solt:;zoldaat;zoldaet;zoldt:
soldat	gegagieerde soldaat;gemene;soldaaat;soldaar;soldaet;soldier;solt:;zoldaat;zoldaet;zoldt:
soldier	gegagieerde soldaat;gemene;soldaaat;soldaar;soldaet;soldat;solt:;zoldaat;zoldaet;zoldt:
soldij boekhouder	soldijboekhouder;zoldij boekhouder
soldij overdrager	soldijoverdrager;zoldijoverdrager
soldijboekhouder	soldij boekhouder;zoldij boekhouder
soldijoverdrager	soldij overdrager;zoldijoverdrager
solt:	gegagieerde soldaat;gemene;soldaaat;soldaar;soldaet;soldat;soldier;zoldaat;zoldaet;zoldt:
sousluitenant	onder leuijtenant;onder lieutenant ;onderluijtenant ;onderluitenant;second lieutenant (military) 
sousluitenant der artillerie	Pl: kapitain luitenant der artillerije;lieutenant der arthillerie;lieutenant der arthillerije;luitenant van de artillerie;luitenant-ingenieur;sousluitenant der artillerij
sousluitenant der artillerij	Pl: kapitain luitenant der artillerije;lieutenant der arthillerie;lieutenant der arthillerije;luitenant van de artillerie;luitenant-ingenieur;sousluitenant der artillerie
spiritual comforter	siekentroost;sieketrooster;ziekentroost;ziekentrooster
sseijlmaker	sail maker;seijlmaker;zeijlmaker;zeilmaker;zeylemaker;zijlemaker
stads hebbergier	stads herbergier;stadsherbergier
stads herbergier	stads hebbergier;stadsherbergier
stadsherbergier	stads hebbergier;stads herbergier
stadsmeester	stadstimmerman
stadstimmerman	stadsmeester
standard-bearer	ensign;ensign bearer;vaanderig;vaandrich ;vaendrig;vandrig;vandrigt;vendrig ;viendrig
steenhouwer	stone mason
steersman	navigator;stuurman
stone mason	steenhouwer
strandwachter	strandwagter
strandwagter	strandwachter
stuurman	navigator;steersman
supercarga	carga;supercargo;supperc:;suppercarga
supercargo	carga;supercarga;supperc:;suppercarga
supervisor of Asian crew members	mandadoor;mandur
supperc:	carga;supercarga;supercargo;suppercarga
suppercarga	carga;supercarga;supercargo;supperc:
surgeon	chirugijn;chirurgeijn;chrirugijn;churugeijn;chururgijn;meester;sirurgeijn
surveyor	landmeeter;landmeter
third barber-surgeon	derde barbier
third mate	derde stuurman;derde waak;derdewaak;derdewaek;hulpstuurman
third surgeon	derde meester;derde neester;derden meester
tin founder	tinsmith
tinsmith	tin founder
trommelaar	drummer;trommelslager
trommelslager	drummer;trommelaar
trompetblazer	trompettier;trumpeter
trompettier	trompetblazer;trumpeter
trumpeter	trompetblazer;trompettier
tweede barbier	second barber-surgeon
tweede bootsman	boatswain (foremast);schieman;schiemand
tweede lanspassaat	second lance-corporal
tweede luitenant	second lieutenant (military)
tweede meester	second surgeon
tweede onderchirurgijn	second-surgeon's mate
tweede scherprechter	tweede scherpregter
tweede scherpregter	tweede scherprechter
tweede schieman	boatswain's mate (foremast);schiemansmaat;schiemansmaet;schimansmaat
tweede stuurman	onderstuurman;second mate
tweede zeilmaker	second sail maker
vaanderig	ensign;ensign bearer;standard-bearer;vaandrich ;vaendrig;vandrig;vandrigt;vendrig ;viendrig
vaandrich 	ensign;ensign bearer;standard-bearer;vaanderig;vaendrig;vandrig;vandrigt;vendrig ;viendrig
vaandrig der blanke burgerij	vaandrig van de burgerij
vaandrig van de burgerij	vaandrig der blanke burgerij
vaendrig	ensign;ensign bearer;standard-bearer;vaanderig;vaandrich ;vandrig;vandrigt;vendrig ;viendrig
vandrig	ensign;ensign bearer;standard-bearer;vaanderig;vaandrich ;vaendrig;vandrigt;vendrig ;viendrig
vandrigt	ensign;ensign bearer;standard-bearer;vaanderig;vaandrich ;vaendrig;vandrig;vendrig ;viendrig
vendrig 	ensign;ensign bearer;standard-bearer;vaanderig;vaandrich ;vaendrig;vandrig;vandrigt;viendrig
verloskundige	midwife
viendrig	ensign;ensign bearer;standard-bearer;vaanderig;vaandrich ;vaendrig;vandrig;vandrigt;vendrig 
vigair	vigairos
vigairos	vigair
vlaggeman	vlaggenman;vlagofficier
vlaggenman	vlaggeman;vlagofficier
vlagofficier	vlaggeman;vlaggenman
waagemaaker	cartwright;waagemaker;wagemaaker;wagemaker
waagemaker	cartwright;waagemaaker;wagemaaker;wagemaker
waard	herbergier;kastelein
wagemaaker	cartwright;waagemaaker;waagemaker;wagemaker
wagemaker	cartwright;waagemaaker;waagemaker;wagemaaker
water fiscaal	waterfiscaal
waterfiscaal	water fiscaal
weapons master	constabel;constapel;gunner
weapons-master's mate	constabelsmaet;constapelsmaat;constapelsmaet;konstabelsmaat
weesmoder	weesmoeder;weezenmoeder
weesmoeder	weesmoder;weezenmoeder
weezenmoeder	weesmoder;weesmoeder
wenkelier	winkelier
wheel maker	rademaker
windmill maker	molenmaker
winkelier	wenkelier
young surgeon	jongchirurgijn
zadelmaaker	sadelmaaker;sadelmaeker;sadelmaker;zadelmaker
zadelmaker	sadelmaaker;sadelmaeker;sadelmaker;zadelmaaker
zeijlmaker	sail maker;seijlmaker;sseijlmaker;zeilmaker;zeylemaker;zijlemaker
zeilmaker	sail maker;seijlmaker;sseijlmaker;zeijlmaker;zeylemaker;zijlemaker
zergeant	gegagieerd sergeant;orderserjant;segeant;sergeant;sergiaant;sergiaent;sergiand;sergiant;serginat;sergt:;serishant;serjant;zergiand;zergiant;zergt:
zergiand	gegagieerd sergeant;orderserjant;segeant;sergeant;sergiaant;sergiaent;sergiand;sergiant;serginat;sergt:;serishant;serjant;zergeant;zergiant;zergt:
zergiant	gegagieerd sergeant;orderserjant;segeant;sergeant;sergiaant;sergiaent;sergiand;sergiant;serginat;sergt:;serishant;serjant;zergeant;zergiand;zergt:
zergt:	gegagieerd sergeant;orderserjant;segeant;sergeant;sergiaant;sergiaent;sergiand;sergiant;serginat;sergt:;serishant;serjant;zergeant;zergiand;zergiant
zeylemaker	sail maker;seijlmaker;sseijlmaker;zeijlmaker;zeilmaker;zijlemaker
ziekenbezoeker	infirmary visitor;krankbesoeker;krankbezoeker;lekelezer
ziekentroost	siekentroost;sieketrooster;spiritual comforter;ziekentrooster
ziekentrooster	siekentroost;sieketrooster;spiritual comforter;ziekentroost
zijlemaker	sail maker;seijlmaker;sseijlmaker;zeijlmaker;zeilmaker;zeylemaker
zilversmid	silversmid;zilversmith
zilversmith	silversmid;zilversmid
zoldaat	gegagieerde soldaat;gemene;soldaaat;soldaar;soldaet;soldat;soldier;solt:;zoldaet;zoldt:
zoldaet	gegagieerde soldaat;gemene;soldaaat;soldaar;soldaet;soldat;soldier;solt:;zoldaat;zoldt:
zoldij boekhouder	soldij boekhouder;soldijboekhouder
zoldijoverdrager	soldij overdrager;soldijoverdrager
zoldt:	gegagieerde soldaat;gemene;soldaaat;soldaar;soldaet;soldat;soldier;solt:;zoldaat;zoldaet
